caseid,period,t,tp,price,buyerAgentId,buyerAgentType,buyerValue,buyerProfit,sellerAgentId,sellerAgentType,sellerCost,sellerProfit
0,1,103.99253873969623,3.9925387396962293,6860,2,ZIAgent,7500,640,12,ZIAgent,2000,4860
0,1,110.42613714372145,10.426137143721448,4094,1,ZIAgent,8000,3906,14,ZIAgent,4000,94
0,1,120.99547944563979,20.995479445639788,4865,6,ZIAgent,5500,635,11,ZIAgent,1000,3865
0,1,122.25154680845768,22.251546808457675,5584,4,ZIAgent,6500,916,13,ZIAgent,3000,2584
0,1,128.36340859634262,28.363408596342623,6056,3,ZIAgent,7000,944,15,ZIAgent,5000,1056
0,2,204.45399329516155,4.453993295161553,4663,3,ZIAgent,7000,2337,12,ZIAgent,2000,2663
0,2,219.32374129687716,19.32374129687716,5631,1,ZIAgent,8000,2369,14,ZIAgent,4000,1631
0,2,269.72538576196126,69.72538576196126,4556,2,ZIAgent,7500,2944,11,ZIAgent,1000,3556
0,2,271.4629873447977,71.46298734479768,4019,4,ZIAgent,6500,2481,13,ZIAgent,3000,1019
0,3,304.57288237135316,4.57288237135316,5871,1,ZIAgent,8000,2129,13,ZIAgent,3000,2871
0,3,309.8936387714421,9.893638771442113,4806,7,ZIAgent,5000,194,12,ZIAgent,2000,2806
0,3,328.9262935368717,28.926293536871697,5650,3,ZIAgent,7000,1350,11,ZIAgent,1000,4650
0,3,333.8665600458893,33.86656004588929,6440,2,ZIAgent,7500,1060,15,ZIAgent,5000,1440
0,3,356.7890218217398,56.78902182173982,4724,4,ZIAgent,6500,1776,14,ZIAgent,4000,724
0,4,402.96631262842817,2.9663126284281702,4655,5,ZIAgent,6000,1345,12,ZIAgent,2000,2655
0,4,404.998018664488,4.998018664487972,5381,1,ZIAgent,8000,2619,15,ZIAgent,5000,381
0,4,413.2470746970117,13.247074697011726,4876,7,ZIAgent,5000,124,11,ZIAgent,1000,3876
0,4,438.51172288162394,38.51172288162394,5628,3,ZIAgent,7000,1372,14,ZIAgent,4000,1628
0,4,462.3447874770237,62.344787477023715,5512,4,ZIAgent,6500,988,13,ZIAgent,3000,2512
0,5,522.1425290477238,22.14252904772377,6486,1,ZIAgent,8000,1514,14,ZIAgent,4000,2486
0,5,526.7740469741825,26.77404697418251,6423,4,ZIAgent,6500,77,11,ZIAgent,1000,5423
0,5,529.1142371781058,29.114237178105782,7255,2,ZIAgent,7500,245,13,ZIAgent,3000,4255
0,5,556.1344522349214,56.134452234921355,5441,6,ZIAgent,5500,59,12,ZIAgent,2000,3441
0,6,601.8759129768374,1.8759129768374123,4301,3,ZIAgent,7000,2699,11,ZIAgent,1000,3301
0,6,622.1189279498435,22.11892794984351,5649,4,ZIAgent,6500,851,13,ZIAgent,3000,2649
0,6,627.810998316072,27.81099831607196,4539,5,ZIAgent,6000,1461,12,ZIAgent,2000,2539
0,6,687.5640432497157,87.56404324971572,6215,1,ZIAgent,8000,1785,16,ZIAgent,6000,215
0,7,709.6652285552996,9.665228555299564,4797,7,ZIAgent,5000,203,11,ZIAgent,1000,3797
0,7,719.6378332994427,19.63783329944272,4395,1,ZIAgent,8000,3605,13,ZIAgent,3000,1395
0,7,730.395623969289,30.395623969288977,6914,2,ZIAgent,7500,586,15,ZIAgent,5000,1914
0,7,731.1322203371695,31.132220337169542,4848,5,ZIAgent,6000,1152,12,ZIAgent,2000,2848
0,7,740.1534399650567,40.15343996505669,4429,3,ZIAgent,7000,2571,14,ZIAgent,4000,429
0,8,803.7731131354559,3.773113135455901,4710,3,ZIAgent,7000,2290,11,ZIAgent,1000,3710
0,8,804.066690329051,4.066690329050971,4775,2,ZIAgent,7500,2725,13,ZIAgent,3000,1775
0,8,813.1869741669519,13.186974166951927,4241,6,ZIAgent,5500,1259,14,ZIAgent,4000,241
0,8,826.5619001327029,26.56190013270293,3467,10,ZIAgent,3500,33,12,ZIAgent,2000,1467
0,8,860.2602833212208,60.260283321220754,6301,1,ZIAgent,8000,1699,15,ZIAgent,5000,1301
0,9,902.394354136767,2.3943541367669923,4434,2,ZIAgent,7500,3066,11,ZIAgent,1000,3434
0,9,904.5033139165964,4.503313916596426,6492,1,ZIAgent,8000,1508,13,ZIAgent,3000,3492
0,9,910.2193331326253,10.219333132625252,4409,4,ZIAgent,6500,2091,14,ZIAgent,4000,409
0,9,977.2870662079387,77.28706620793866,5076,3,ZIAgent,7000,1924,12,ZIAgent,2000,3076
0,10,1015.6591457975712,15.659145797571227,5544,4,ZIAgent,6500,956,11,ZIAgent,1000,4544
0,10,1018.9361360816431,18.9361360816431,5957,3,ZIAgent,7000,1043,15,ZIAgent,5000,957
0,10,1027.2504987273348,27.250498727334843,6835,2,ZIAgent,7500,665,14,ZIAgent,4000,2835
0,10,1069.4235258888764,69.42352588887638,3465,8,ZIAgent,4500,1035,12,ZIAgent,2000,1465
0,10,1075.9548603021221,75.95486030212214,7341,1,ZIAgent,8000,659,16,ZIAgent,6000,1341
0,10,1079.7980852725095,79.79808527250952,5124,5,ZIAgent,6000,876,13,ZIAgent,3000,2124
0,11,1143.4928451666622,43.492845166662164,4954,6,ZIAgent,5500,546,11,ZIAgent,1000,3954
0,11,1146.3900929450037,46.390092945003744,5047,4,ZIAgent,6500,1453,14,ZIAgent,4000,1047
0,11,1155.8163003688994,55.81630036889942,5102,1,ZIAgent,8000,2898,13,ZIAgent,3000,2102
0,11,1158.5573595559304,58.55735955593036,4498,2,ZIAgent,7500,3002,12,ZIAgent,2000,2498
0,12,1202.3914358271247,2.391435827124724,5338,6,ZIAgent,5500,162,14,ZIAgent,4000,1338
0,12,1206.8192914659146,6.819291465914603,4683,3,ZIAgent,7000,2317,11,ZIAgent,1000,3683
0,12,1207.595633326897,7.595633326897087,6077,2,ZIAgent,7500,1423,16,ZIAgent,6000,77
0,12,1231.1613325220267,31.16133252202667,4376,5,ZIAgent,6000,1624,13,ZIAgent,3000,1376
0,12,1299.8614755481913,99.86147554819127,6968,1,ZIAgent,8000,1032,12,ZIAgent,2000,4968
0,13,1303.0300200039558,3.0300200039557694,6452,4,ZIAgent,6500,48,14,ZIAgent,4000,2452
0,13,1306.232110660189,6.232110660188937,3789,2,ZIAgent,7500,3711,11,ZIAgent,1000,2789
0,13,1325.7887677195815,25.78876771958153,3609,9,ZIAgent,4000,391,13,ZIAgent,3000,609
0,13,1331.845471518866,31.845471518865907,4148,7,ZIAgent,5000,852,12,ZIAgent,2000,2148
0,13,1389.523686568429,89.52368656842896,5410,1,ZIAgent,8000,2590,15,ZIAgent,5000,410
0,14,1404.3126481224654,4.312648122465362,3742,3,ZIAgent,7000,3258,11,ZIAgent,1000,2742
0,14,1405.3635428814866,5.363542881486637,5256,5,ZIAgent,6000,744,12,ZIAgent,2000,3256
0,14,1419.5405273427536,19.54052734275365,5173,4,ZIAgent,6500,1327,13,ZIAgent,3000,2173
0,14,1486.507219289814,86.50721928981397,5729,2,ZIAgent,7500,1771,15,ZIAgent,5000,729
0,15,1505.3580991340175,5.358099134017493,5241,4,ZIAgent,6500,1259,11,ZIAgent,1000,4241
0,15,1520.0633200054733,20.063320005473315,6946,3,ZIAgent,7000,54,12,ZIAgent,2000,4946
0,15,1553.3911333320084,53.391133332008394,5083,5,ZIAgent,6000,917,15,ZIAgent,5000,83
0,15,1566.3806046889474,66.38060468894741,5324,1,ZIAgent,8000,2676,13,ZIAgent,3000,2324
0,16,1606.5538297273226,6.553829727322636,5814,2,ZIAgent,7500,1686,11,ZIAgent,1000,4814
0,16,1608.9834529457605,8.983452945760519,6170,4,ZIAgent,6500,330,12,ZIAgent,2000,4170
0,16,1621.22158813659,21.22158813659007,5152,5,ZIAgent,6000,848,13,ZIAgent,3000,2152
0,16,1667.7669877275516,67.76698772755162,6674,1,ZIAgent,8000,1326,14,ZIAgent,4000,2674
0,17,1713.1396840535558,13.139684053555811,5521,5,ZIAgent,6000,479,11,ZIAgent,1000,4521
0,17,1715.0957654070173,15.095765407017325,6270,3,ZIAgent,7000,730,12,ZIAgent,2000,4270
0,17,1730.9622795763237,30.96227957632368,3934,4,ZIAgent,6500,2566,13,ZIAgent,3000,934
0,17,1734.5920129252472,34.59201292524722,4116,1,ZIAgent,8000,3884,14,ZIAgent,4000,116
0,17,1776.0595889934314,76.05958899343136,5425,2,ZIAgent,7500,2075,15,ZIAgent,5000,425
0,18,1808.339734033503,8.339734033502964,3542,9,ZIAgent,4000,458,12,ZIAgent,2000,1542
0,18,1813.2189059195318,13.218905919531835,5086,5,ZIAgent,6000,914,13,ZIAgent,3000,2086
0,18,1820.4695449550234,20.469544955023366,5899,1,ZIAgent,8000,2101,15,ZIAgent,5000,899
0,18,1853.3428738422244,53.342873842224435,4185,3,ZIAgent,7000,2815,11,ZIAgent,1000,3185
0,18,1886.1534553117604,86.15345531176035,4632,4,ZIAgent,6500,1868,14,ZIAgent,4000,632
0,19,1901.8078011153584,1.8078011153584157,5185,1,ZIAgent,8000,2815,12,ZIAgent,2000,3185
0,19,1910.8927778103803,10.892777810380267,4186,8,ZIAgent,4500,314,11,ZIAgent,1000,3186
0,19,1918.407447423653,18.40744742365291,5352,4,ZIAgent,6500,1148,14,ZIAgent,4000,1352
0,19,1919.653540039236,19.653540039236077,4316,5,ZIAgent,6000,1684,13,ZIAgent,3000,1316
0,19,1920.968471193956,20.96847119395602,6318,2,ZIAgent,7500,1182,15,ZIAgent,5000,1318
0,20,2004.093242067962,4.09324206796191,7568,1,ZIAgent,8000,432,15,ZIAgent,5000,2568
0,20,2013.7993053055231,13.799305305523148,4442,4,ZIAgent,6500,2058,12,ZIAgent,2000,2442
0,20,2017.8520024528104,17.85200245281044,4473,5,ZIAgent,6000,1527,11,ZIAgent,1000,3473
0,20,2073.270413276787,73.27041327678717,5203,2,ZIAgent,7500,2297,13,ZIAgent,3000,2203
0,21,2112.1890776697146,12.189077669714607,6221,4,ZIAgent,6500,279,15,ZIAgent,5000,1221
0,21,2117.5777471349666,17.577747134966557,5365,5,ZIAgent,6000,635,11,ZIAgent,1000,4365
0,21,2140.5354044624182,40.53540446241823,5662,3,ZIAgent,7000,1338,12,ZIAgent,2000,3662
0,21,2143.390537115909,43.390537115908955,5531,1,ZIAgent,8000,2469,14,ZIAgent,4000,1531
0,22,2209.927448187359,9.927448187359005,4882,5,ZIAgent,6000,1118,14,ZIAgent,4000,882
0,22,2217.1044934684337,17.104493468433702,7214,1,ZIAgent,8000,786,13,ZIAgent,3000,4214
0,22,2229.1894934254856,29.18949342548558,5746,3,ZIAgent,7000,1254,11,ZIAgent,1000,4746
0,22,2261.3849403883833,61.38494038838326,5618,2,ZIAgent,7500,1882,15,ZIAgent,5000,618
0,22,2264.7229908140353,64.72299081403526,6173,4,ZIAgent,6500,327,12,ZIAgent,2000,4173
0,23,2300.5523477582883,0.5523477582883061,2494,4,ZIAgent,6500,4006,11,ZIAgent,1000,1494
0,23,2308.33368301598,8.333683015980114,3687,1,ZIAgent,8000,4313,12,ZIAgent,2000,1687
0,23,2324.722972478684,24.722972478683914,5829,3,ZIAgent,7000,1171,13,ZIAgent,3000,2829
0,23,2382.8845103649833,82.88451036498327,4800,2,ZIAgent,7500,2700,14,ZIAgent,4000,800
0,24,2420.9535640407603,20.953564040760284,5992,4,ZIAgent,6500,508,14,ZIAgent,4000,1992
0,24,2427.7295299303946,27.72952993039462,4012,8,ZIAgent,4500,488,11,ZIAgent,1000,3012
0,24,2455.960600568977,55.96060056897704,4866,2,ZIAgent,7500,2634,13,ZIAgent,3000,1866
0,24,2474.1147382471113,74.11473824711129,3993,5,ZIAgent,6000,2007,12,ZIAgent,2000,1993
0,25,2505.0063959924514,5.0063959924514165,4125,6,ZIAgent,5500,1375,11,ZIAgent,1000,3125
0,25,2522.706103563698,22.70610356369798,6462,1,ZIAgent,8000,1538,15,ZIAgent,5000,1462
0,25,2544.608375792004,44.60837579200415,5222,2,ZIAgent,7500,2278,12,ZIAgent,2000,3222
0,25,2573.3872357931064,73.38723579310636,4762,3,ZIAgent,7000,2238,14,ZIAgent,4000,762
0,26,2610.0664318602935,10.066431860293505,6054,1,ZIAgent,8000,1946,13,ZIAgent,3000,3054
0,26,2613.606168395922,13.60616839592194,5707,2,ZIAgent,7500,1793,14,ZIAgent,4000,1707
0,26,2620.803617759705,20.80361775970505,5589,4,ZIAgent,6500,911,11,ZIAgent,1000,4589
0,26,2646.80032475207,46.80032475207008,6040,3,ZIAgent,7000,960,12,ZIAgent,2000,4040
0,27,2708.30694790469,8.306947904689878,5009,6,ZIAgent,5500,491,13,ZIAgent,3000,2009
0,27,2716.6802070563467,16.680207056346717,5248,1,ZIAgent,8000,2752,14,ZIAgent,4000,1248
0,27,2717.7872738690407,17.787273869040746,5551,5,ZIAgent,6000,449,15,ZIAgent,5000,551
0,27,2740.6689266804397,40.668926680439654,4859,4,ZIAgent,6500,1641,12,ZIAgent,2000,2859
0,28,2802.5312856319533,2.531285631953324,6354,3,ZIAgent,7000,646,13,ZIAgent,3000,3354
0,28,2805.041038075192,5.041038075191864,7381,1,ZIAgent,8000,619,12,ZIAgent,2000,5381
0,28,2809.4477069806826,9.447706980682597,5555,5,ZIAgent,6000,445,14,ZIAgent,4000,1555
0,28,2825.2703709283774,25.27037092837736,5342,4,ZIAgent,6500,1158,11,ZIAgent,1000,4342
0,28,2841.4438195246266,41.44381952462663,6527,2,ZIAgent,7500,973,15,ZIAgent,5000,1527
0,29,2913.8332109182807,13.833210918280656,7455,2,ZIAgent,7500,45,16,ZIAgent,6000,1455
0,29,2918.8973381964556,18.89733819645562,5866,1,ZIAgent,8000,2134,12,ZIAgent,2000,3866
0,29,2941.9809901307526,41.980990130752616,4116,3,ZIAgent,7000,2884,14,ZIAgent,4000,116
0,29,2992.0538052774964,92.0538052774964,5215,4,ZIAgent,6500,1285,15,ZIAgent,5000,215
0,30,3000.844768552108,0.8447685521077801,4389,4,ZIAgent,6500,2111,11,ZIAgent,1000,3389
0,30,3018.8909637372954,18.89096373729535,3711,2,ZIAgent,7500,3789,12,ZIAgent,2000,1711
0,30,3030.865093344059,30.865093344059005,4265,5,ZIAgent,6000,1735,14,ZIAgent,4000,265
0,30,3033.9861656325265,33.986165632526536,4825,6,ZIAgent,5500,675,13,ZIAgent,3000,1825
0,30,3097.507345660491,97.50734566049096,6912,1,ZIAgent,8000,1088,15,ZIAgent,5000,1912
0,31,3104.047453214776,4.047453214775942,5648,1,ZIAgent,8000,2352,11,ZIAgent,1000,4648
0,31,3134.51437780132,34.514377801319824,6143,3,ZIAgent,7000,857,14,ZIAgent,4000,2143
0,31,3138.592458189757,38.59245818975705,4828,2,ZIAgent,7500,2672,12,ZIAgent,2000,2828
0,31,3183.6900848374266,83.69008483742664,6448,4,ZIAgent,6500,52,13,ZIAgent,3000,3448
0,32,3204.685712055016,4.685712055016211,7399,2,ZIAgent,7500,101,14,ZIAgent,4000,3399
0,32,3220.925097096601,20.925097096600894,4858,4,ZIAgent,6500,1642,11,ZIAgent,1000,3858
0,32,3252.515496588122,52.515496588122005,5156,6,ZIAgent,5500,344,13,ZIAgent,3000,2156
0,32,3264.0607919357753,64.06079193577534,6486,1,ZIAgent,8000,1514,16,ZIAgent,6000,486
0,33,3313.0462757595,13.046275759500077,4600,3,ZIAgent,7000,2400,14,ZIAgent,4000,600
0,33,3317.057672826294,17.057672826294038,5320,4,ZIAgent,6500,1180,12,ZIAgent,2000,3320
0,33,3330.6159002005916,30.615900200591568,4486,7,ZIAgent,5000,514,11,ZIAgent,1000,3486
0,33,3337.6647219373235,37.66472193732352,3650,2,ZIAgent,7500,3850,13,ZIAgent,3000,650
0,33,3361.814324125637,61.814324125637086,7381,1,ZIAgent,8000,619,17,ZIAgent,7000,381
0,34,3401.7663479490366,1.7663479490365717,5318,2,ZIAgent,7500,2182,14,ZIAgent,4000,1318
0,34,3412.2804791827125,12.280479182712497,3923,7,ZIAgent,5000,1077,11,ZIAgent,1000,2923
0,34,3425.27841377166,25.27841377165987,5122,1,ZIAgent,8000,2878,15,ZIAgent,5000,122
0,34,3444.0726637994403,44.072663799440306,5856,3,ZIAgent,7000,1144,13,ZIAgent,3000,2856
0,34,3456.6908638313585,56.690863831358456,4994,5,ZIAgent,6000,1006,12,ZIAgent,2000,2994
0,35,3515.0774321473323,15.077432147332274,6981,1,ZIAgent,8000,1019,15,ZIAgent,5000,1981
0,35,3515.266865188767,15.266865188767042,5865,3,ZIAgent,7000,1135,11,ZIAgent,1000,4865
0,35,3546.9738648299713,46.97386482997126,5174,4,ZIAgent,6500,1326,14,ZIAgent,4000,1174
0,35,3564.3916716527665,64.39167165276649,4067,6,ZIAgent,5500,1433,12,ZIAgent,2000,2067
0,35,3569.064802227149,69.0648022271489,5421,2,ZIAgent,7500,2079,13,ZIAgent,3000,2421
0,36,3604.035583503803,4.035583503803082,2589,10,ZIAgent,3500,911,11,ZIAgent,1000,1589
0,36,3606.672941708055,6.6729417080550775,3775,1,ZIAgent,8000,4225,12,ZIAgent,2000,1775
0,36,3619.168605725799,19.168605725798898,4650,5,ZIAgent,6000,1350,13,ZIAgent,3000,1650
0,36,3627.5279392108887,27.52793921088869,6997,2,ZIAgent,7500,503,16,ZIAgent,6000,997
0,36,3649.356430807148,49.35643080714817,5409,6,ZIAgent,5500,91,14,ZIAgent,4000,1409
0,37,3704.765926745008,4.765926745008073,4478,7,ZIAgent,5000,522,12,ZIAgent,2000,2478
0,37,3711.828236549459,11.82823654945878,5234,1,ZIAgent,8000,2766,13,ZIAgent,3000,2234
0,37,3734.8693019300376,34.869301930037636,4507,4,ZIAgent,6500,1993,11,ZIAgent,1000,3507
0,37,3740.1697343142764,40.16973431427641,6329,2,ZIAgent,7500,1171,14,ZIAgent,4000,2329
0,37,3790.4529914460873,90.45299144608725,5912,3,ZIAgent,7000,1088,15,ZIAgent,5000,912
0,38,3807.3366329047567,7.336632904756698,4676,7,ZIAgent,5000,324,13,ZIAgent,3000,1676
0,38,3809.545042829206,9.545042829206068,3420,4,ZIAgent,6500,3080,12,ZIAgent,2000,1420
0,38,3816.3190357248823,16.31903572488227,5754,1,ZIAgent,8000,2246,14,ZIAgent,4000,1754
0,38,3816.536726519597,16.53672651959687,3143,9,ZIAgent,4000,857,11,ZIAgent,1000,2143
0,39,3907.540161521146,7.540161521145819,5364,1,ZIAgent,8000,2636,12,ZIAgent,2000,3364
0,39,3909.2623118959536,9.262311895953644,3701,8,ZIAgent,4500,799,11,ZIAgent,1000,2701
0,39,3919.1307911646945,19.13079116469453,6481,4,ZIAgent,6500,19,13,ZIAgent,3000,3481
0,39,3932.1822762772417,32.182276277241726,6162,3,ZIAgent,7000,838,14,ZIAgent,4000,2162
0,39,3984.908036883351,84.90803688335109,6971,2,ZIAgent,7500,529,15,ZIAgent,5000,1971
0,40,4014.8451695100184,14.845169510018422,6857,2,ZIAgent,7500,643,14,ZIAgent,4000,2857
0,40,4036.614685422306,36.61468542230614,5005,3,ZIAgent,7000,1995,13,ZIAgent,3000,2005
0,40,4041.5662261853754,41.5662261853754,4315,6,ZIAgent,5500,1185,11,ZIAgent,1000,3315
0,40,4066.990465114328,66.99046511432789,6686,1,ZIAgent,8000,1314,12,ZIAgent,2000,4686
0,41,4104.445859446535,4.445859446534996,4485,7,ZIAgent,5000,515,12,ZIAgent,2000,2485
0,41,4110.615282001974,10.615282001974265,6874,2,ZIAgent,7500,626,13,ZIAgent,3000,3874
0,41,4126.460423307667,26.460423307667043,6063,4,ZIAgent,6500,437,11,ZIAgent,1000,5063
0,41,4131.4788431710695,31.478843171069457,5777,3,ZIAgent,7000,1223,14,ZIAgent,4000,1777
0,41,4150.380455958558,50.38045595855783,5185,5,ZIAgent,6000,815,15,ZIAgent,5000,185
0,42,4215.248307157378,15.248307157377894,5598,5,ZIAgent,6000,402,14,ZIAgent,4000,1598
0,42,4222.173132112769,22.173132112769053,5030,4,ZIAgent,6500,1470,15,ZIAgent,5000,30
0,42,4227.154717032537,27.15471703253661,4295,1,ZIAgent,8000,3705,12,ZIAgent,2000,2295
0,42,4240.99584355156,40.99584355156003,5706,2,ZIAgent,7500,1794,11,ZIAgent,1000,4706
0,42,4295.073745019004,95.07374501900358,4234,6,ZIAgent,5500,1266,13,ZIAgent,3000,1234
0,43,4309.62927022549,9.629270225489563,6265,2,ZIAgent,7500,1235,14,ZIAgent,4000,2265
0,43,4321.482434339086,21.482434339085557,6185,3,ZIAgent,7000,815,11,ZIAgent,1000,5185
0,43,4352.901527462369,52.901527462368904,5102,1,ZIAgent,8000,2898,12,ZIAgent,2000,3102
0,43,4367.123919409219,67.12391940921862,5636,5,ZIAgent,6000,364,15,ZIAgent,5000,636
0,44,4410.30209295777,10.302092957769673,4019,1,ZIAgent,8000,3981,12,ZIAgent,2000,2019
0,44,4420.060862139747,20.06086213974686,4500,2,ZIAgent,7500,3000,13,ZIAgent,3000,1500
0,44,4421.837997726187,21.837997726186586,6682,3,ZIAgent,7000,318,14,ZIAgent,4000,2682
0,44,4450.656645049247,50.656645049247345,4241,8,ZIAgent,4500,259,11,ZIAgent,1000,3241
0,44,4455.6429900848,55.64299008479975,5255,6,ZIAgent,5500,245,15,ZIAgent,5000,255
0,45,4509.822649479464,9.822649479464417,6404,1,ZIAgent,8000,1596,12,ZIAgent,2000,4404
0,45,4521.082877284239,21.082877284238748,4995,7,ZIAgent,5000,5,13,ZIAgent,3000,1995
0,45,4554.58754174022,54.58754174022033,6237,3,ZIAgent,7000,763,16,ZIAgent,6000,237
0,45,4555.474492316295,55.474492316295255,5842,2,ZIAgent,7500,1658,11,ZIAgent,1000,4842
0,45,4593.166692587666,93.16669258766615,5580,5,ZIAgent,6000,420,14,ZIAgent,4000,1580
0,46,4604.259526847301,4.259526847300549,6088,3,ZIAgent,7000,912,12,ZIAgent,2000,4088
0,46,4605.13622066216,5.136220662159758,5823,2,ZIAgent,7500,1677,13,ZIAgent,3000,2823
0,46,4611.618482589926,11.618482589926316,3112,4,ZIAgent,6500,3388,11,ZIAgent,1000,2112
0,46,4628.374122226473,28.374122226473446,6587,1,ZIAgent,8000,1413,14,ZIAgent,4000,2587
0,46,4635.794946034002,35.79494603400235,5458,6,ZIAgent,5500,42,15,ZIAgent,5000,458
0,47,4717.303173664346,17.303173664346104,5451,5,ZIAgent,6000,549,11,ZIAgent,1000,4451
0,47,4723.858092073052,23.85809207305192,5140,3,ZIAgent,7000,1860,13,ZIAgent,3000,2140
0,47,4733.548136222969,33.54813622296933,6122,4,ZIAgent,6500,378,12,ZIAgent,2000,4122
0,47,4759.28475879194,59.284758791939566,6677,1,ZIAgent,8000,1323,15,ZIAgent,5000,1677
0,48,4805.006657066309,5.006657066309344,6317,3,ZIAgent,7000,683,12,ZIAgent,2000,4317
0,48,4818.425928323071,18.425928323071275,6083,4,ZIAgent,6500,417,15,ZIAgent,5000,1083
0,48,4821.962861755828,21.96286175582827,5709,1,ZIAgent,8000,2291,14,ZIAgent,4000,1709
0,48,4885.585560756281,85.58556075628076,5236,6,ZIAgent,5500,264,11,ZIAgent,1000,4236
0,49,4907.711154237389,7.711154237388655,4128,1,ZIAgent,8000,3872,12,ZIAgent,2000,2128
0,49,4915.390390300002,15.390390300001854,4276,2,ZIAgent,7500,3224,14,ZIAgent,4000,276
0,49,4982.261397544907,82.26139754490669,4466,7,ZIAgent,5000,534,11,ZIAgent,1000,3466
0,50,5002.095883148074,2.095883148073881,5710,5,ZIAgent,6000,290,13,ZIAgent,3000,2710
0,50,5013.252732488291,13.252732488291258,6072,1,ZIAgent,8000,1928,14,ZIAgent,4000,2072
0,50,5025.5095400160035,25.509540016003484,6531,2,ZIAgent,7500,969,11,ZIAgent,1000,5531
0,50,5040.96745978216,40.967459782160404,5854,3,ZIAgent,7000,1146,15,ZIAgent,5000,854
0,50,5087.112364167243,87.11236416724296,4371,8,ZIAgent,4500,129,12,ZIAgent,2000,2371
0,51,5107.3732500808555,7.3732500808555415,5026,2,ZIAgent,7500,2474,13,ZIAgent,3000,2026
0,51,5123.2524843570045,23.252484357004505,5253,5,ZIAgent,6000,747,14,ZIAgent,4000,1253
0,51,5129.202182012692,29.202182012691992,3799,4,ZIAgent,6500,2701,12,ZIAgent,2000,1799
0,51,5137.188706216203,37.18870621620317,6214,1,ZIAgent,8000,1786,11,ZIAgent,1000,5214
0,51,5170.836168319164,70.83616831916424,5913,3,ZIAgent,7000,1087,15,ZIAgent,5000,913
0,52,5213.490307812187,13.490307812186984,6253,4,ZIAgent,6500,247,14,ZIAgent,4000,2253
0,52,5229.354825265088,29.35482526508804,6763,3,ZIAgent,7000,237,12,ZIAgent,2000,4763
0,52,5230.361742264102,30.36174226410185,5873,2,ZIAgent,7500,1627,11,ZIAgent,1000,4873
0,52,5232.442824040912,32.442824040911546,5652,1,ZIAgent,8000,2348,15,ZIAgent,5000,652
0,52,5256.806649416954,56.806649416954315,3986,8,ZIAgent,4500,514,13,ZIAgent,3000,986
0,53,5302.8328478776775,2.8328478776775228,3838,7,ZIAgent,5000,1162,11,ZIAgent,1000,2838
0,53,5307.968053531388,7.96805353138825,2051,5,ZIAgent,6000,3949,12,ZIAgent,2000,51
0,53,5330.028527262225,30.028527262224998,4183,4,ZIAgent,6500,2317,14,ZIAgent,4000,183
0,53,5335.203829986186,35.203829986186065,6085,3,ZIAgent,7000,915,13,ZIAgent,3000,3085
0,54,5408.495360126463,8.49536012646331,3806,7,ZIAgent,5000,1194,12,ZIAgent,2000,1806
0,54,5414.2367685628515,14.236768562851466,5524,5,ZIAgent,6000,476,11,ZIAgent,1000,4524
0,54,5418.013670253298,18.013670253298187,5567,2,ZIAgent,7500,1933,15,ZIAgent,5000,567
0,54,5437.821211986777,37.82121198677669,5949,3,ZIAgent,7000,1051,13,ZIAgent,3000,2949
0,54,5462.9592865771,62.9592865771001,6356,1,ZIAgent,8000,1644,14,ZIAgent,4000,2356
0,55,5500.733627607855,0.7336276078549417,2296,7,ZIAgent,5000,2704,12,ZIAgent,2000,296
0,55,5507.045251676196,7.045251676196131,6967,1,ZIAgent,8000,1033,13,ZIAgent,3000,3967
0,55,5512.8098519928335,12.8098519928335,6630,3,ZIAgent,7000,370,16,ZIAgent,6000,630
0,55,5527.790998584494,27.790998584494446,5038,5,ZIAgent,6000,962,11,ZIAgent,1000,4038
0,55,5535.088854840229,35.08885484022903,6545,2,ZIAgent,7500,955,15,ZIAgent,5000,1545
0,55,5591.394876766477,91.39487676647695,6067,4,ZIAgent,6500,433,14,ZIAgent,4000,2067
0,56,5602.469793561698,2.46979356169777,3268,9,ZIAgent,4000,732,11,ZIAgent,1000,2268
0,56,5611.722790031344,11.72279003134372,7155,1,ZIAgent,8000,845,17,ZIAgent,7000,155
0,56,5611.767097608335,11.767097608334552,5920,2,ZIAgent,7500,1580,12,ZIAgent,2000,3920
0,56,5617.957424909693,17.957424909693145,5740,5,ZIAgent,6000,260,13,ZIAgent,3000,2740
0,56,5643.070589714258,43.07058971425795,5294,3,ZIAgent,7000,1706,15,ZIAgent,5000,294
0,57,5704.614236858719,4.6142368587188685,2752,1,ZIAgent,8000,5248,11,ZIAgent,1000,1752
0,57,5739.09625790371,39.09625790370956,5818,3,ZIAgent,7000,1182,12,ZIAgent,2000,3818
0,57,5739.28977124322,39.28977124321955,5534,5,ZIAgent,6000,466,14,ZIAgent,4000,1534
0,57,5777.006852297271,77.0068522972706,6369,2,ZIAgent,7500,1131,15,ZIAgent,5000,1369
0,58,5802.127189781266,2.12718978126577,4199,6,ZIAgent,5500,1301,13,ZIAgent,3000,1199
0,58,5812.970108627489,12.970108627489026,4213,4,ZIAgent,6500,2287,14,ZIAgent,4000,213
0,58,5814.625712273955,14.625712273955287,6574,2,ZIAgent,7500,926,16,ZIAgent,6000,574
0,58,5821.33644822853,21.33644822852966,5905,3,ZIAgent,7000,1095,12,ZIAgent,2000,3905
0,58,5832.006717509156,32.00671750915626,3977,9,ZIAgent,4000,23,11,ZIAgent,1000,2977
0,59,5907.9500029183155,7.950002918315477,6837,2,ZIAgent,7500,663,15,ZIAgent,5000,1837
0,59,5911.320614687468,11.32061468746815,7138,1,ZIAgent,8000,862,12,ZIAgent,2000,5138
0,59,5914.423652677881,14.423652677881364,6122,4,ZIAgent,6500,378,14,ZIAgent,4000,2122
0,59,5944.601631328106,44.60163132810612,3186,3,ZIAgent,7000,3814,13,ZIAgent,3000,186
0,59,5950.990159198964,50.99015919896374,2793,1,ZIAgent,3000,207,11,ZIAgent,1000,1793
0,60,6010.173985244709,10.173985244709002,6109,1,ZIAgent,8000,1891,13,ZIAgent,3000,3109
0,60,6026.365373953911,26.36537395391133,4138,2,ZIAgent,7500,3362,11,ZIAgent,1000,3138
0,60,6031.641610193569,31.64161019356925,4654,3,ZIAgent,7000,2346,14,ZIAgent,4000,654
0,60,6038.92063510042,38.92063510042044,5063,4,ZIAgent,6500,1437,15,ZIAgent,5000,63
0,60,6046.412367307415,46.41236730741457,3947,5,ZIAgent,6000,2053,12,ZIAgent,2000,1947
0,61,6105.221714237655,5.221714237654851,6789,1,ZIAgent,8000,1211,13,ZIAgent,3000,3789
0,61,6108.149148306639,8.14914830663929,5441,2,ZIAgent,7500,2059,14,ZIAgent,4000,1441
0,61,6108.263856700648,8.26385670064792,3610,8,ZIAgent,4500,890,11,ZIAgent,1000,2610
0,61,6132.701043702362,32.70104370236186,4638,7,ZIAgent,5000,362,12,ZIAgent,2000,2638
0,61,6171.311109485871,71.31110948587138,6461,3,ZIAgent,7000,539,16,ZIAgent,6000,461
0,61,6197.368749518269,97.3687495182694,5315,4,ZIAgent,6500,1185,15,ZIAgent,5000,315
0,62,6207.75865355471,7.758653554709781,3911,4,ZIAgent,6500,2589,13,ZIAgent,3000,911
0,62,6211.138826741327,11.138826741326739,4083,1,ZIAgent,8000,3917,12,ZIAgent,2000,2083
0,62,6217.727719700558,17.727719700557827,4200,2,ZIAgent,7500,3300,14,ZIAgent,4000,200
0,62,6231.69407951985,31.694079519849765,4484,7,ZIAgent,5000,516,11,ZIAgent,1000,3484
0,62,6240.127631599409,40.12763159940914,5276,5,ZIAgent,6000,724,15,ZIAgent,5000,276
0,63,6303.305809082956,3.30580908295633,6958,3,ZIAgent,7000,42,11,ZIAgent,1000,5958
0,63,6305.430047944398,5.430047944398211,3679,1,ZIAgent,8000,4321,13,ZIAgent,3000,679
0,63,6349.258669414073,49.258669414072756,5823,2,ZIAgent,7500,1677,14,ZIAgent,4000,1823
0,64,6404.878133490269,4.878133490268738,3852,4,ZIAgent,6500,2648,12,ZIAgent,2000,1852
0,64,6405.511543459011,5.5115434590106815,5304,1,ZIAgent,8000,2696,14,ZIAgent,4000,1304
0,64,6439.111111802685,39.11111180268472,6602,3,ZIAgent,7000,398,11,ZIAgent,1000,5602
0,64,6446.654915777903,46.654915777902715,5004,2,ZIAgent,7500,2496,15,ZIAgent,5000,4
0,65,6500.555781110287,0.555781110287171,1145,1,ZIAgent,8000,6855,11,ZIAgent,1000,145
0,65,6512.890029406247,12.890029406246867,6260,2,ZIAgent,7500,1240,15,ZIAgent,5000,1260
0,65,6534.835191911215,34.83519191121468,4381,3,ZIAgent,7000,2619,14,ZIAgent,4000,381
0,65,6564.075557600438,64.0755576004376,4888,7,ZIAgent,5000,112,12,ZIAgent,2000,2888
0,65,6572.205861276102,72.20586127610204,4366,4,ZIAgent,6500,2134,13,ZIAgent,3000,1366
0,66,6604.0897067591,4.089706759100409,6617,3,ZIAgent,7000,383,11,ZIAgent,1000,5617
0,66,6605.2481535491415,5.248153549141534,6059,2,ZIAgent,7500,1441,14,ZIAgent,4000,2059
0,66,6611.604092598639,11.604092598639,5460,6,ZIAgent,5500,40,13,ZIAgent,3000,2460
0,66,6652.803995326617,52.80399532661704,6318,1,ZIAgent,8000,1682,12,ZIAgent,2000,4318
0,67,6700.501442183047,0.5014421830474021,6454,1,ZIAgent,8000,1546,12,ZIAgent,2000,4454
0,67,6703.690190684307,3.690190684306799,4827,2,ZIAgent,7500,2673,11,ZIAgent,1000,3827
0,67,6753.204141807512,53.204141807512315,5567,4,ZIAgent,6500,933,13,ZIAgent,3000,2567
0,68,6804.002232454412,4.002232454411569,4138,7,ZIAgent,5000,862,12,ZIAgent,2000,2138
0,68,6806.031594452427,6.031594452427271,4716,2,ZIAgent,7500,2784,13,ZIAgent,3000,1716
0,68,6825.188052054891,25.18805205489116,4677,6,ZIAgent,5500,823,11,ZIAgent,1000,3677
0,68,6899.792182929855,99.79218292985479,6853,1,ZIAgent,8000,1147,15,ZIAgent,5000,1853
0,69,6914.4500425419255,14.45004254192554,5783,2,ZIAgent,7500,1717,13,ZIAgent,3000,2783
0,69,6938.564895927351,38.564895927351245,3156,6,ZIAgent,5500,2344,11,ZIAgent,1000,2156
0,69,6941.18055643179,41.18055643179014,6088,3,ZIAgent,7000,912,16,ZIAgent,6000,88
0,69,6976.415250004032,76.4152500040318,4726,5,ZIAgent,6000,1274,12,ZIAgent,2000,2726
0,70,7002.968230927629,2.9682309276286105,3795,7,ZIAgent,5000,1205,13,ZIAgent,3000,795
0,70,7010.577329845495,10.577329845495115,5494,1,ZIAgent,8000,2506,12,ZIAgent,2000,3494
0,70,7028.146072394746,28.146072394745715,6296,3,ZIAgent,7000,704,15,ZIAgent,5000,1296
0,70,7030.945893060792,30.945893060791605,5192,6,ZIAgent,5500,308,11,ZIAgent,1000,4192
0,70,7052.473089787446,52.47308978744604,6206,2,ZIAgent,7500,1294,14,ZIAgent,4000,2206
0,71,7102.284521990402,2.284521990402027,4792,4,ZIAgent,6500,1708,13,ZIAgent,3000,1792
0,71,7108.4732907390835,8.473290739083495,5180,3,ZIAgent,7000,1820,11,ZIAgent,1000,4180
0,71,7119.5971170641515,19.597117064151462,5649,1,ZIAgent,8000,2351,15,ZIAgent,5000,649
0,71,7155.133713117661,55.13371311766059,6703,2,ZIAgent,7500,797,16,ZIAgent,6000,703
0,71,7158.562694337021,58.56269433702073,5480,6,ZIAgent,5500,20,12,ZIAgent,2000,3480
0,72,7202.926889531729,2.9268895317291026,2949,6,ZIAgent,5500,2551,12,ZIAgent,2000,949
0,72,7210.725610439912,10.725610439912089,5956,2,ZIAgent,7500,1544,11,ZIAgent,1000,4956
0,72,7222.7468605456,22.746860545599702,6767,1,ZIAgent,8000,1233,15,ZIAgent,5000,1767
0,72,7231.701278231673,31.701278231673314,4825,7,ZIAgent,5000,175,13,ZIAgent,3000,1825
0,73,7307.072953145371,7.072953145370775,3694,6,ZIAgent,5500,1806,11,ZIAgent,1000,2694
0,73,7315.7337618242755,15.733761824275462,3531,3,ZIAgent,7000,3469,12,ZIAgent,2000,1531
0,73,7330.781317529204,30.78131752920399,6455,1,ZIAgent,8000,1545,16,ZIAgent,6000,455
0,73,7333.914575012424,33.91457501242439,7112,2,ZIAgent,7500,388,14,ZIAgent,4000,3112
0,73,7389.946744358931,89.94674435893103,5239,4,ZIAgent,6500,1261,15,ZIAgent,5000,239
0,74,7400.477616683643,0.47761668364273646,3271,4,ZIAgent,6500,3229,12,ZIAgent,2000,1271
0,74,7401.625094672667,1.625094672666819,7165,1,ZIAgent,8000,835,11,ZIAgent,1000,6165
0,74,7416.506269457048,16.506269457047893,5040,2,ZIAgent,7500,2460,15,ZIAgent,5000,40
0,74,7484.664332450226,84.66433245022563,4447,7,ZIAgent,5000,553,13,ZIAgent,3000,1447
0,75,7513.86722588683,13.867225886830056,6010,3,ZIAgent,7000,990,15,ZIAgent,5000,1010
0,75,7519.469820085273,19.46982008527266,5734,5,ZIAgent,6000,266,12,ZIAgent,2000,3734
0,75,7523.320134011695,23.32013401169479,2904,6,ZIAgent,5500,2596,11,ZIAgent,1000,1904
0,75,7537.182208020669,37.18220802066935,6494,4,ZIAgent,6500,6,13,ZIAgent,3000,3494
0,75,7551.312944129218,51.31294412921761,5805,2,ZIAgent,7500,1695,14,ZIAgent,4000,1805
0,76,7607.501942571282,7.501942571281688,6251,1,ZIAgent,8000,1749,13,ZIAgent,3000,3251
0,76,7612.197746852617,12.197746852616547,5092,5,ZIAgent,6000,908,12,ZIAgent,2000,3092
0,76,7666.963163574339,66.96316357433898,6052,3,ZIAgent,7000,948,15,ZIAgent,5000,1052
0,76,7690.375108481625,90.37510848162492,4327,2,ZIAgent,7500,3173,11,ZIAgent,1000,3327
0,77,7702.286205005614,2.2862050056137377,5334,2,ZIAgent,7500,2166,14,ZIAgent,4000,1334
0,77,7717.955638244287,17.955638244287,5855,3,ZIAgent,7000,1145,15,ZIAgent,5000,855
0,77,7723.811794787444,23.81179478744434,6167,4,ZIAgent,6500,333,12,ZIAgent,2000,4167
0,77,7742.824544460512,42.82454446051179,3364,9,ZIAgent,4000,636,11,ZIAgent,1000,2364
0,78,7802.015311295086,2.0153112950856666,3782,9,ZIAgent,4000,218,11,ZIAgent,1000,2782
0,78,7813.264255767586,13.264255767586292,7074,1,ZIAgent,8000,926,13,ZIAgent,3000,4074
0,78,7815.577598194383,15.577598194383427,6470,4,ZIAgent,6500,30,14,ZIAgent,4000,2470
0,78,7816.557137331996,16.557137331996273,3975,7,ZIAgent,5000,1025,12,ZIAgent,2000,1975
0,79,7904.511810894769,4.511810894769042,7759,1,ZIAgent,8000,241,12,ZIAgent,2000,5759
0,79,7909.802131038164,9.80213103816368,4774,5,ZIAgent,6000,1226,13,ZIAgent,3000,1774
0,79,7925.933176038734,25.933176038734018,4640,7,ZIAgent,5000,360,11,ZIAgent,1000,3640
0,80,8003.849155483886,3.8491554838856246,7210,2,ZIAgent,7500,290,15,ZIAgent,5000,2210
0,80,8011.2072450482665,11.207245048266486,4788,3,ZIAgent,7000,2212,11,ZIAgent,1000,3788
0,80,8015.663272414677,15.663272414676612,4678,7,ZIAgent,5000,322,13,ZIAgent,3000,1678
0,80,8017.486311669398,17.486311669397764,5804,4,ZIAgent,6500,696,12,ZIAgent,2000,3804
0,80,8058.11761129029,58.11761129029037,6648,1,ZIAgent,8000,1352,14,ZIAgent,4000,2648
0,81,8105.057524818006,5.0575248180057315,5508,3,ZIAgent,7000,1492,11,ZIAgent,1000,4508
0,81,8115.788973318244,15.788973318243734,3432,9,ZIAgent,4000,568,12,ZIAgent,2000,1432
0,81,8116.178254604511,16.178254604510585,5415,1,ZIAgent,8000,2585,13,ZIAgent,3000,2415
0,81,8141.677277263212,41.67727726321209,5812,4,ZIAgent,6500,688,15,ZIAgent,5000,812
0,81,8157.375902469151,57.37590246915079,4484,5,ZIAgent,6000,1516,14,ZIAgent,4000,484
0,82,8207.675290815134,7.675290815133849,5366,4,ZIAgent,6500,1134,13,ZIAgent,3000,2366
0,82,8213.599872888637,13.599872888637037,4511,7,ZIAgent,5000,489,11,ZIAgent,1000,3511
0,82,8217.16150571917,17.161505719170236,5673,3,ZIAgent,7000,1327,15,ZIAgent,5000,673
0,82,8223.558109739068,23.55810973906773,7137,2,ZIAgent,7500,363,12,ZIAgent,2000,5137
0,82,8233.272791227068,33.2727912270675,6713,1,ZIAgent,8000,1287,14,ZIAgent,4000,2713
0,83,8302.402178810838,2.40217881083845,4719,7,ZIAgent,5000,281,11,ZIAgent,1000,3719
0,83,8308.50694454591,8.5069445459103,4234,4,ZIAgent,6500,2266,12,ZIAgent,2000,2234
0,83,8330.674750022648,30.674750022648368,5725,5,ZIAgent,6000,275,15,ZIAgent,5000,725
0,83,8338.05094996311,38.050949963109815,5397,1,ZIAgent,8000,2603,14,ZIAgent,4000,1397
0,84,8406.152546765046,6.1525467650462815,5024,5,ZIAgent,6000,976,11,ZIAgent,1000,4024
0,84,8416.48034944007,16.480349440069403,6158,4,ZIAgent,6500,342,12,ZIAgent,2000,4158
0,84,8419.235041185393,19.23504118539313,6221,2,ZIAgent,7500,1279,14,ZIAgent,4000,2221
0,84,8443.609403135579,43.60940313557876,6488,3,ZIAgent,7000,512,13,ZIAgent,3000,3488
0,84,8460.731978338388,60.73197833838822,6899,1,ZIAgent,8000,1101,15,ZIAgent,5000,1899
0,85,8518.605947957245,18.605947957245007,4820,2,ZIAgent,7500,2680,11,ZIAgent,1000,3820
0,85,8534.648297430947,34.64829743094742,5538,4,ZIAgent,6500,962,14,ZIAgent,4000,1538
0,85,8548.09469233947,48.094692339469475,6149,3,ZIAgent,7000,851,13,ZIAgent,3000,3149
0,85,8554.924976828646,54.92497682864632,6070,1,ZIAgent,8000,1930,16,ZIAgent,6000,70
0,85,8567.368158805977,67.36815880597715,4327,6,ZIAgent,5500,1173,12,ZIAgent,2000,2327
0,86,8602.56427798579,2.564277985789886,5770,1,ZIAgent,8000,2230,12,ZIAgent,2000,3770
0,86,8614.819421562615,14.81942156261539,6206,2,ZIAgent,7500,1294,11,ZIAgent,1000,5206
0,86,8623.534607124824,23.534607124824106,5657,3,ZIAgent,7000,1343,14,ZIAgent,4000,1657
0,86,8629.754847133569,29.754847133568546,3835,8,ZIAgent,4500,665,13,ZIAgent,3000,835
0,86,8631.021996735959,31.021996735958965,5523,5,ZIAgent,6000,477,15,ZIAgent,5000,523
0,87,8703.495704246629,3.49570424662852,5137,4,ZIAgent,6500,1363,14,ZIAgent,4000,1137
0,87,8704.024627115776,4.024627115775729,4774,2,ZIAgent,7500,2726,12,ZIAgent,2000,2774
0,87,8723.445549922315,23.445549922314967,6496,1,ZIAgent,8000,1504,11,ZIAgent,1000,5496
0,87,8768.343630201969,68.34363020196906,5108,5,ZIAgent,6000,892,15,ZIAgent,5000,108
0,88,8810.8122827744,10.812282774399137,6278,4,ZIAgent,6500,222,12,ZIAgent,2000,4278
0,88,8813.226816053977,13.226816053977018,4550,2,ZIAgent,7500,2950,14,ZIAgent,4000,550
0,88,8835.408048988487,35.40804898848728,4089,1,ZIAgent,8000,3911,11,ZIAgent,1000,3089
0,88,8845.605605053084,45.60560505308422,5505,5,ZIAgent,6000,495,13,ZIAgent,3000,2505
0,89,8932.324313031895,32.324313031895144,4577,6,ZIAgent,5500,923,12,ZIAgent,2000,2577
0,89,8938.362743876305,38.3627438763051,5968,3,ZIAgent,7000,1032,13,ZIAgent,3000,2968
0,89,8976.504584016951,76.50458401695141,6921,1,ZIAgent,8000,1079,16,ZIAgent,6000,921
0,89,8986.857319681865,86.85731968186519,5577,5,ZIAgent,6000,423,11,ZIAgent,1000,4577
0,90,9015.012150497992,15.01215049799248,4181,3,ZIAgent,7000,2819,13,ZIAgent,3000,1181
0,90,9021.766526320396,21.766526320396224,4517,5,ZIAgent,6000,1483,11,ZIAgent,1000,3517
0,90,9047.020043955561,47.02004395556105,5875,2,ZIAgent,7500,1625,14,ZIAgent,4000,1875
0,90,9070.399374247712,70.39937424771233,4691,4,ZIAgent,6500,1809,12,ZIAgent,2000,2691
0,91,9108.883957214073,8.883957214073234,4143,7,ZIAgent,5000,857,12,ZIAgent,2000,2143
0,91,9120.94942544677,20.949425446769965,5583,3,ZIAgent,7000,1417,11,ZIAgent,1000,4583
0,91,9150.312003440427,50.31200344042736,7201,2,ZIAgent,7500,299,16,ZIAgent,6000,1201
0,91,9167.946268073681,67.9462680736815,5817,5,ZIAgent,6000,183,13,ZIAgent,3000,2817
0,91,9172.578700744318,72.57870074431776,6087,1,ZIAgent,8000,1913,15,ZIAgent,5000,1087
0,92,9203.91909296358,3.919092963580624,4449,6,ZIAgent,5500,1051,12,ZIAgent,2000,2449
0,92,9212.680887598828,12.680887598828122,2965,2,ZIAgent,7500,4535,11,ZIAgent,1000,1965
0,92,9229.215374969874,29.215374969873665,7852,1,ZIAgent,8000,148,14,ZIAgent,4000,3852
0,92,9261.727604110874,61.72760411087438,6683,3,ZIAgent,7000,317,16,ZIAgent,6000,683
0,92,9262.415073394877,62.415073394877254,5170,5,ZIAgent,6000,830,13,ZIAgent,3000,2170
0,93,9300.988237625865,0.9882376258647128,6434,2,ZIAgent,7500,1066,11,ZIAgent,1000,5434
0,93,9312.451597740608,12.451597740608122,5793,4,ZIAgent,6500,707,15,ZIAgent,5000,793
0,93,9320.515344741694,20.515344741694207,5282,6,ZIAgent,5500,218,13,ZIAgent,3000,2282
0,93,9323.213224949928,23.21322494992819,4702,3,ZIAgent,7000,2298,14,ZIAgent,4000,702
0,93,9328.737338648687,28.737338648687,4285,7,ZIAgent,5000,715,12,ZIAgent,2000,2285
0,94,9411.353228633783,11.353228633783147,6582,3,ZIAgent,7000,418,15,ZIAgent,5000,1582
0,94,9419.848243584893,19.84824358489277,5433,5,ZIAgent,6000,567,11,ZIAgent,1000,4433
0,94,9421.06126070195,21.061260701950232,3955,1,ZIAgent,8000,4045,12,ZIAgent,2000,1955
0,94,9451.329728913031,51.32972891303143,5270,6,ZIAgent,5500,230,14,ZIAgent,4000,1270
0,94,9474.90796384266,74.90796384265923,5875,2,ZIAgent,7500,1625,13,ZIAgent,3000,2875
0,95,9501.6436496737,1.6436496737005655,5910,3,ZIAgent,7000,1090,13,ZIAgent,3000,2910
0,95,9505.006659664677,5.0066596646775,1419,3,ZIAgent,2000,581,11,ZIAgent,1000,419
0,95,9508.02097071831,8.0209707183094,4900,6,ZIAgent,5500,600,14,ZIAgent,4000,900
0,95,9511.385031394924,11.385031394924226,6936,1,ZIAgent,8000,1064,12,ZIAgent,2000,4936
0,96,9601.640500164327,1.6405001643270225,3607,7,ZIAgent,5000,1393,13,ZIAgent,3000,607
0,96,9603.584539107565,3.5845391075654334,4713,5,ZIAgent,6000,1287,11,ZIAgent,1000,3713
0,96,9624.36563595828,24.36563595828011,6113,4,ZIAgent,6500,387,14,ZIAgent,4000,2113
0,96,9640.76290801496,40.762908014959976,6874,2,ZIAgent,7500,626,12,ZIAgent,2000,4874
0,96,9683.376538501976,83.37653850197603,7872,1,ZIAgent,8000,128,17,ZIAgent,7000,872
0,97,9706.647441406352,6.6474414063523,3947,8,ZIAgent,4500,553,11,ZIAgent,1000,2947
0,97,9710.203474960032,10.203474960031599,4971,1,ZIAgent,8000,3029,12,ZIAgent,2000,2971
0,97,9727.233996240873,27.23399624087324,4796,2,ZIAgent,7500,2704,13,ZIAgent,3000,1796
0,97,9745.269472147016,45.26947214701613,5953,4,ZIAgent,6500,547,15,ZIAgent,5000,953
0,97,9783.865824619987,83.8658246199866,5975,3,ZIAgent,7000,1025,14,ZIAgent,4000,1975
0,98,9807.051995631,7.051995630999954,5605,1,ZIAgent,8000,2395,12,ZIAgent,2000,3605
0,98,9845.93146523821,45.931465238210876,5309,5,ZIAgent,6000,691,14,ZIAgent,4000,1309
0,98,9848.689114005458,48.68911400545767,6360,3,ZIAgent,7000,640,16,ZIAgent,6000,360
0,98,9860.573161894774,60.573161894773875,4950,7,ZIAgent,5000,50,11,ZIAgent,1000,3950
0,98,9862.278745881773,62.27874588177292,5572,2,ZIAgent,7500,1928,15,ZIAgent,5000,572
0,98,9889.530518866437,89.53051886643698,5592,4,ZIAgent,6500,908,13,ZIAgent,3000,2592
0,99,9904.773679186093,4.773679186093432,7321,1,ZIAgent,8000,679,15,ZIAgent,5000,2321
0,99,9913.561887903943,13.561887903942988,6967,3,ZIAgent,7000,33,13,ZIAgent,3000,3967
0,99,9926.065615937721,26.065615937721304,6828,2,ZIAgent,7500,672,16,ZIAgent,6000,828
0,99,9933.526534781175,33.52653478117463,5641,4,ZIAgent,6500,859,11,ZIAgent,1000,4641
0,99,9946.581878638513,46.581878638513444,3236,6,ZIAgent,5500,2264,12,ZIAgent,2000,1236
0,99,9997.520997508422,97.52099750842171,5171,5,ZIAgent,6000,829,14,ZIAgent,4000,1171
0,100,10001.251802068002,1.2518020680017798,4757,3,ZIAgent,7000,2243,11,ZIAgent,1000,3757
0,100,10012.01667631275,12.01667631275086,4448,1,ZIAgent,8000,3552,12,ZIAgent,2000,2448
0,100,10017.040463144762,17.040463144761816,4210,8,ZIAgent,4500,290,13,ZIAgent,3000,1210
0,100,10069.993231480672,69.99323148067197,6213,2,ZIAgent,7500,1287,15,ZIAgent,5000,1213
