caseid,period,t,tp,price,buyerAgentId,buyerAgentType,buyerValue,buyerProfit,sellerAgentId,sellerAgentType,sellerCost,sellerProfit
0,1,106.97090712658525,6.970907126585246,4375,2,ZIAgent,7500,3125,11,ZIAgent,1000,3375
0,1,108.17089322244878,8.170893222448782,6165,1,ZIAgent,8000,1835,14,ZIAgent,4000,2165
0,1,115.15241977112724,15.152419771127242,3563,7,ZIAgent,5000,1437,12,ZIAgent,2000,1563
0,2,204.0997042071914,4.099704207191394,6257,3,ZIAgent,7000,743,11,ZIAgent,1000,5257
0,2,228.698397595931,28.698397595931,4016,6,ZIAgent,5500,1484,13,ZIAgent,3000,1016
0,2,229.0094231152705,29.009423115270494,6349,4,ZIAgent,6500,151,15,ZIAgent,5000,1349
0,2,237.29031729189128,37.290317291891284,4164,2,ZIAgent,7500,3336,12,ZIAgent,2000,2164
0,2,271.3973775333084,71.39737753330837,5829,5,ZIAgent,6000,171,14,ZIAgent,4000,1829
0,3,302.5025993225346,2.502599322534593,2661,8,ZIAgent,4500,1839,12,ZIAgent,2000,661
0,3,308.5324002144165,8.532400214416498,2989,10,ZIAgent,3500,511,11,ZIAgent,1000,1989
0,3,325.2552099153914,25.25520991539139,4992,1,ZIAgent,8000,3008,13,ZIAgent,3000,1992
0,3,370.1738139052095,70.1738139052095,6225,2,ZIAgent,7500,1275,16,ZIAgent,6000,225
0,4,406.5338596363547,6.533859636354691,6586,2,ZIAgent,7500,914,11,ZIAgent,1000,5586
0,4,414.2912104517009,14.29121045170092,6334,3,ZIAgent,7000,666,13,ZIAgent,3000,3334
0,4,430.94316506023915,30.943165060239153,5807,1,ZIAgent,8000,2193,12,ZIAgent,2000,3807
0,4,446.2113868260631,46.21138682606312,6231,4,ZIAgent,6500,269,14,ZIAgent,4000,2231
0,5,503.0180069072314,3.0180069072313813,4003,1,ZIAgent,8000,3997,11,ZIAgent,1000,3003
0,5,526.2120178675998,26.212017867599798,4575,2,ZIAgent,7500,2925,12,ZIAgent,2000,2575
0,5,538.3967576062114,38.396757606211395,5284,3,ZIAgent,7000,1716,13,ZIAgent,3000,2284
0,5,540.2107499810505,40.210749981050526,5562,4,ZIAgent,6500,938,14,ZIAgent,4000,1562
0,6,607.3726971220989,7.372697122098884,4633,7,ZIAgent,5000,367,12,ZIAgent,2000,2633
0,6,615.4422009855681,15.442200985568093,2930,6,ZIAgent,5500,2570,11,ZIAgent,1000,1930
0,6,615.8257951381543,15.825795138154263,4708,5,ZIAgent,6000,1292,13,ZIAgent,3000,1708
0,6,656.2170187439181,56.21701874391806,6135,2,ZIAgent,7500,1365,16,ZIAgent,6000,135
0,6,690.7829087701795,90.78290877017946,6041,1,ZIAgent,8000,1959,14,ZIAgent,4000,2041
0,7,708.240076178948,8.240076178948016,4314,4,ZIAgent,6500,2186,11,ZIAgent,1000,3314
0,7,725.6068313291677,25.606831329167676,5760,3,ZIAgent,7000,1240,13,ZIAgent,3000,2760
0,7,727.2542559101332,27.254255910133224,5515,2,ZIAgent,7500,1985,12,ZIAgent,2000,3515
0,7,728.4585264358825,28.458526435882504,5542,5,ZIAgent,6000,458,14,ZIAgent,4000,1542
0,8,806.0873945006109,6.0873945006109125,5898,2,ZIAgent,7500,1602,15,ZIAgent,5000,898
0,8,827.6413928196465,27.641392819646512,6250,1,ZIAgent,8000,1750,11,ZIAgent,1000,5250
0,8,834.2438805858345,34.24388058583452,5448,4,ZIAgent,6500,1052,14,ZIAgent,4000,1448
0,8,841.2295911882317,41.229591188231666,5279,5,ZIAgent,6000,721,13,ZIAgent,3000,2279
0,9,905.9501417560583,5.950141756058315,5319,4,ZIAgent,6500,1181,15,ZIAgent,5000,319
0,9,919.5816180253635,19.58161802536347,4659,2,ZIAgent,7500,2841,12,ZIAgent,2000,2659
0,9,950.5167238328404,50.5167238328404,5847,1,ZIAgent,8000,2153,11,ZIAgent,1000,4847
0,9,974.9280026385115,74.92800263851154,5181,3,ZIAgent,7000,1819,14,ZIAgent,4000,1181
0,10,1014.6231437800391,14.623143780039072,5010,1,ZIAgent,8000,2990,13,ZIAgent,3000,2010
0,10,1018.2298571042164,18.22985710421642,5496,6,ZIAgent,5500,4,11,ZIAgent,1000,4496
0,10,1030.7895983212668,30.789598321266794,6121,2,ZIAgent,7500,1379,15,ZIAgent,5000,1121
0,10,1037.6382085203963,37.63820852039635,5007,5,ZIAgent,6000,993,14,ZIAgent,4000,1007
0,10,1040.693657948343,40.69365794834289,4432,8,ZIAgent,4500,68,12,ZIAgent,2000,2432
0,11,1101.9975103522631,1.9975103522631343,6224,1,ZIAgent,8000,1776,13,ZIAgent,3000,3224
0,11,1107.963396892042,7.963396892042056,4601,7,ZIAgent,5000,399,14,ZIAgent,4000,601
0,11,1142.2041689108478,42.204168910847784,6737,2,ZIAgent,7500,763,12,ZIAgent,2000,4737
0,12,1206.1112115299263,6.111211529926322,5441,5,ZIAgent,6000,559,11,ZIAgent,1000,4441
0,12,1213.2722664072005,13.272266407200505,4428,1,ZIAgent,8000,3572,12,ZIAgent,2000,2428
0,12,1218.4346262258523,18.4346262258523,4745,6,ZIAgent,5500,755,13,ZIAgent,3000,1745
0,13,1310.600382969628,10.600382969628072,4294,7,ZIAgent,5000,706,11,ZIAgent,1000,3294
0,13,1319.7729675284252,19.77296752842517,5170,4,ZIAgent,6500,1330,13,ZIAgent,3000,2170
0,13,1339.2910518090907,39.29105180909073,7174,1,ZIAgent,8000,826,17,ZIAgent,7000,174
0,13,1340.6727951761543,40.672795176154295,6039,2,ZIAgent,7500,1461,15,ZIAgent,5000,1039
0,13,1353.7176288946532,53.71762889465322,5830,5,ZIAgent,6000,170,12,ZIAgent,2000,3830
0,13,1387.1378849148268,87.13788491482683,5235,6,ZIAgent,5500,265,14,ZIAgent,4000,1235
0,14,1406.941511682704,6.941511682704004,7088,1,ZIAgent,8000,912,12,ZIAgent,2000,5088
0,14,1420.7820656092777,20.78206560927765,6258,3,ZIAgent,7000,742,15,ZIAgent,5000,1258
0,14,1422.7132925579663,22.71329255796627,5366,6,ZIAgent,5500,134,13,ZIAgent,3000,2366
0,14,1427.524305982662,27.5243059826621,6766,2,ZIAgent,7500,734,11,ZIAgent,1000,5766
0,14,1437.3828991767336,37.382899176733645,5175,5,ZIAgent,6000,825,14,ZIAgent,4000,1175
0,15,1501.9038586880358,1.9038586880358253,5437,4,ZIAgent,6500,1063,15,ZIAgent,5000,437
0,15,1509.9429439359283,9.94294393592827,6300,1,ZIAgent,8000,1700,14,ZIAgent,4000,2300
0,15,1530.8908932288316,30.8908932288316,5847,2,ZIAgent,7500,1653,11,ZIAgent,1000,4847
0,15,1544.1838444595755,44.18384445957554,6525,3,ZIAgent,7000,475,13,ZIAgent,3000,3525
0,15,1568.27130712969,68.27130712969006,5286,5,ZIAgent,6000,714,12,ZIAgent,2000,3286
0,16,1604.8929627128066,4.892962712806593,4563,4,ZIAgent,6500,1937,11,ZIAgent,1000,3563
0,16,1614.770178234362,14.770178234361993,5835,1,ZIAgent,8000,2165,13,ZIAgent,3000,2835
0,16,1618.80055714597,18.80055714597006,6057,2,ZIAgent,7500,1443,16,ZIAgent,6000,57
0,16,1635.4194445558078,35.419444555807786,5430,3,ZIAgent,7000,1570,12,ZIAgent,2000,3430
0,17,1709.3919270746117,9.391927074611658,6126,3,ZIAgent,7000,874,11,ZIAgent,1000,5126
0,17,1709.782306076104,9.782306076104078,6107,4,ZIAgent,6500,393,12,ZIAgent,2000,4107
0,17,1726.4685571904436,26.468557190443562,6906,1,ZIAgent,8000,1094,14,ZIAgent,4000,2906
0,17,1757.6758604632012,57.67586046320116,3999,8,ZIAgent,4500,501,13,ZIAgent,3000,999
0,17,1795.4764111178085,95.47641111780854,6660,2,ZIAgent,7500,840,16,ZIAgent,6000,660
0,18,1817.9372587960604,17.937258796060405,6070,2,ZIAgent,7500,1430,14,ZIAgent,4000,2070
0,18,1822.830529372832,22.83052937283196,5678,3,ZIAgent,7000,1322,11,ZIAgent,1000,4678
0,18,1828.8118422660332,28.81184226603318,6252,1,ZIAgent,8000,1748,13,ZIAgent,3000,3252
0,18,1885.9215156800535,85.92151568005352,5181,4,ZIAgent,6500,1319,12,ZIAgent,2000,3181
0,19,1914.9129426552158,14.91294265521583,5306,2,ZIAgent,7500,2194,13,ZIAgent,3000,2306
0,19,1953.059369300223,53.0593693002229,5085,5,ZIAgent,6000,915,11,ZIAgent,1000,4085
0,19,1964.0907460694343,64.09074606943432,4466,3,ZIAgent,7000,2534,14,ZIAgent,4000,466
0,20,2012.7948946185816,12.794894618581566,5648,3,ZIAgent,7000,1352,12,ZIAgent,2000,3648
0,20,2020.6280704611554,20.628070461155403,4891,1,ZIAgent,8000,3109,11,ZIAgent,1000,3891
0,20,2041.562326107167,41.56232610716711,5800,2,ZIAgent,7500,1700,15,ZIAgent,5000,800
0,20,2042.8105696925763,42.81056969257634,4523,4,ZIAgent,6500,1977,13,ZIAgent,3000,1523
0,20,2059.033110836494,59.03311083649396,4436,7,ZIAgent,5000,564,14,ZIAgent,4000,436
0,21,2103.0277391240875,3.027739124087475,4282,7,ZIAgent,5000,718,13,ZIAgent,3000,1282
0,21,2122.3614057034692,22.361405703469245,6047,3,ZIAgent,7000,953,11,ZIAgent,1000,5047
0,21,2123.4292886876588,23.429288687658754,6084,4,ZIAgent,6500,416,16,ZIAgent,6000,84
0,21,2129.4438111168515,29.44381111685152,5699,1,ZIAgent,8000,2301,14,ZIAgent,4000,1699
0,21,2140.5060444449564,40.50604444495639,2778,2,ZIAgent,7500,4722,12,ZIAgent,2000,778
0,22,2206.3638250671465,6.363825067146536,6485,2,ZIAgent,7500,1015,12,ZIAgent,2000,4485
0,22,2219.721650557959,19.721650557959038,5850,5,ZIAgent,6000,150,14,ZIAgent,4000,1850
0,22,2221.4456044339595,21.44560443395949,4430,7,ZIAgent,5000,570,11,ZIAgent,1000,3430
0,22,2266.1565518144257,66.15655181442571,6693,3,ZIAgent,7000,307,13,ZIAgent,3000,3693
0,23,2307.2906828020173,7.2906828020172725,3189,7,ZIAgent,5000,1811,11,ZIAgent,1000,2189
0,23,2323.8944631500826,23.89446315008263,5801,2,ZIAgent,7500,1699,13,ZIAgent,3000,2801
0,23,2347.806116697772,47.80611669777181,6453,1,ZIAgent,8000,1547,12,ZIAgent,2000,4453
0,23,2350.57775683457,50.57775683457021,5241,3,ZIAgent,7000,1759,14,ZIAgent,4000,1241
0,24,2401.1649374589174,1.164937458917393,5896,5,ZIAgent,6000,104,12,ZIAgent,2000,3896
0,24,2408.162993951938,8.162993951938006,6701,2,ZIAgent,7500,799,16,ZIAgent,6000,701
0,24,2408.857202304993,8.857202304992825,5956,3,ZIAgent,7000,1044,14,ZIAgent,4000,1956
0,24,2419.2264271991344,19.226427199134378,4646,1,ZIAgent,8000,3354,11,ZIAgent,1000,3646
0,24,2473.045888975992,73.04588897599206,4296,4,ZIAgent,6500,2204,13,ZIAgent,3000,1296
0,25,2513.451492216887,13.45149221688689,4628,3,ZIAgent,7000,2372,13,ZIAgent,3000,1628
0,25,2522.8738836258917,22.87388362589172,5257,4,ZIAgent,6500,1243,12,ZIAgent,2000,3257
0,25,2527.546869700808,27.5468697008082,5499,2,ZIAgent,7500,2001,14,ZIAgent,4000,1499
0,25,2537.275443505566,37.27544350556582,3522,9,ZIAgent,4000,478,11,ZIAgent,1000,2522
0,25,2542.8736154529574,42.87361545295744,7029,1,ZIAgent,8000,971,16,ZIAgent,6000,1029
0,25,2573.168392913248,73.16839291324823,5510,5,ZIAgent,6000,490,15,ZIAgent,5000,510
0,26,2609.5326379658713,9.532637965871345,5895,4,ZIAgent,6500,605,15,ZIAgent,5000,895
0,26,2610.436483129573,10.436483129572935,5806,1,ZIAgent,8000,2194,12,ZIAgent,2000,3806
0,26,2614.727194441071,14.727194441070878,5323,5,ZIAgent,6000,677,11,ZIAgent,1000,4323
0,26,2660.254938552132,60.25493855213199,3603,8,ZIAgent,4500,897,13,ZIAgent,3000,603
0,26,2679.3731860957023,79.3731860957023,6633,3,ZIAgent,7000,367,14,ZIAgent,4000,2633
0,26,2694.963737681539,94.96373768153899,7167,2,ZIAgent,7500,333,16,ZIAgent,6000,1167
0,27,2713.4822694580794,13.482269458079372,5888,2,ZIAgent,7500,1612,12,ZIAgent,2000,3888
0,27,2736.9031669522965,36.90316695229649,7484,1,ZIAgent,8000,516,15,ZIAgent,5000,2484
0,27,2743.5375732937055,43.537573293705464,5607,4,ZIAgent,6500,893,11,ZIAgent,1000,4607
0,27,2774.956693703807,74.9566937038071,4330,3,ZIAgent,7000,2670,13,ZIAgent,3000,1330
0,28,2805.523928491869,5.523928491868901,6498,1,ZIAgent,8000,1502,13,ZIAgent,3000,3498
0,28,2808.8032873698157,8.803287369815735,4116,4,ZIAgent,6500,2384,12,ZIAgent,2000,2116
0,28,2813.656486218341,13.656486218340888,4248,5,ZIAgent,6000,1752,11,ZIAgent,1000,3248
0,28,2885.001820424477,85.00182042447705,6925,2,ZIAgent,7500,575,14,ZIAgent,4000,2925
0,29,2915.9759065384915,15.975906538491472,5092,2,ZIAgent,7500,2408,12,ZIAgent,2000,3092
0,29,2923.212889125303,23.21288912530281,5418,3,ZIAgent,7000,1582,13,ZIAgent,3000,2418
0,29,2935.5295112300423,35.52951123004232,5015,5,ZIAgent,6000,985,11,ZIAgent,1000,4015
0,29,2939.695633090597,39.69563309059686,5296,6,ZIAgent,5500,204,15,ZIAgent,5000,296
0,29,2957.3016969345445,57.30169693454445,7867,1,ZIAgent,8000,133,16,ZIAgent,6000,1867
0,30,3002.4929652180545,2.492965218054451,3156,7,ZIAgent,5000,1844,13,ZIAgent,3000,156
0,30,3008.5782972688407,8.578297268840743,6478,1,ZIAgent,8000,1522,15,ZIAgent,5000,1478
0,30,3009.243080523079,9.243080523078788,4232,8,ZIAgent,4500,268,11,ZIAgent,1000,3232
0,30,3040.669852912838,40.669852912837996,4556,5,ZIAgent,6000,1444,14,ZIAgent,4000,556
0,30,3096.7955184517646,96.79551845176456,5444,4,ZIAgent,6500,1056,12,ZIAgent,2000,3444
0,30,3099.6774480528966,99.67744805289658,7182,2,ZIAgent,7500,318,17,ZIAgent,7000,182
0,31,3111.586051799506,11.586051799506095,6135,1,ZIAgent,8000,1865,15,ZIAgent,5000,1135
0,31,3114.3100826791,14.310082679100105,5258,4,ZIAgent,6500,1242,14,ZIAgent,4000,1258
0,31,3115.0376045648354,15.03760456483542,4501,3,ZIAgent,7000,2499,12,ZIAgent,2000,2501
0,31,3126.2814979405093,26.281497940509325,4041,6,ZIAgent,5500,1459,13,ZIAgent,3000,1041
0,31,3196.6778780628288,96.67787806282877,6034,2,ZIAgent,7500,1466,11,ZIAgent,1000,5034
0,32,3204.37637976869,4.376379768690185,6194,2,ZIAgent,7500,1306,15,ZIAgent,5000,1194
0,32,3213.1998965041985,13.199896504198477,5497,3,ZIAgent,7000,1503,12,ZIAgent,2000,3497
0,32,3216.1537499995584,16.153749999558386,7043,1,ZIAgent,8000,957,14,ZIAgent,4000,3043
0,32,3243.432757926548,43.43275792654822,5997,5,ZIAgent,6000,3,13,ZIAgent,3000,2997
0,32,3262.091672663998,62.091672663998,4132,4,ZIAgent,6500,2368,11,ZIAgent,1000,3132
0,33,3303.063693985097,3.063693985096961,4981,5,ZIAgent,6000,1019,11,ZIAgent,1000,3981
0,33,3315.42351690721,15.423516907209887,3274,4,ZIAgent,6500,3226,13,ZIAgent,3000,274
0,33,3341.459078370838,41.45907837083814,5349,2,ZIAgent,7500,2151,15,ZIAgent,5000,349
0,33,3362.711484041638,62.71148404163796,5883,3,ZIAgent,7000,1117,14,ZIAgent,4000,1883
0,33,3389.217560869339,89.2175608693392,6911,1,ZIAgent,8000,1089,12,ZIAgent,2000,4911
0,34,3420.95868621533,20.95868621533009,5096,6,ZIAgent,5500,404,11,ZIAgent,1000,4096
0,34,3420.990078572463,20.990078572463062,5539,1,ZIAgent,8000,2461,13,ZIAgent,3000,2539
0,34,3446.4990103621144,46.499010362114404,5131,3,ZIAgent,7000,1869,14,ZIAgent,4000,1131
0,34,3456.4607264160986,56.46072641609862,4888,2,ZIAgent,7500,2612,12,ZIAgent,2000,2888
0,35,3504.5524299441845,4.552429944184496,3165,5,ZIAgent,6000,2835,11,ZIAgent,1000,2165
0,35,3510.3740290211913,10.37402902119129,4777,3,ZIAgent,7000,2223,13,ZIAgent,3000,1777
0,35,3511.0677864387385,11.067786438738494,6186,1,ZIAgent,8000,1814,16,ZIAgent,6000,186
0,35,3559.047545367558,59.04754536755809,4530,2,ZIAgent,7500,2970,14,ZIAgent,4000,530
0,36,3602.349059823428,2.3490598234279787,6103,4,ZIAgent,6500,397,12,ZIAgent,2000,4103
0,36,3602.9989903114383,2.9989903114383196,3963,3,ZIAgent,7000,3037,11,ZIAgent,1000,2963
0,36,3623.253005595993,23.253005595992818,4703,1,ZIAgent,8000,3297,14,ZIAgent,4000,703
0,36,3636.16069566248,36.160695662480066,6752,2,ZIAgent,7500,748,16,ZIAgent,6000,752
0,36,3643.454463800656,43.45446380065596,4336,6,ZIAgent,5500,1164,13,ZIAgent,3000,1336
0,37,3703.0740520624863,3.0740520624863166,7668,1,ZIAgent,8000,332,13,ZIAgent,3000,4668
0,37,3711.786757944716,11.7867579447161,6311,2,ZIAgent,7500,1189,12,ZIAgent,2000,4311
0,37,3723.9096151830863,23.909615183086316,5913,4,ZIAgent,6500,587,11,ZIAgent,1000,4913
0,37,3728.674637947585,28.67463794758487,5462,6,ZIAgent,5500,38,14,ZIAgent,4000,1462
0,38,3811.644570351847,11.644570351847051,5073,2,ZIAgent,7500,2427,11,ZIAgent,1000,4073
0,38,3823.216358916749,23.21635891674896,4349,5,ZIAgent,6000,1651,14,ZIAgent,4000,349
0,38,3848.043288885588,48.04328888558803,7102,1,ZIAgent,8000,898,17,ZIAgent,7000,102
0,38,3875.0771214139113,75.0771214139113,4829,7,ZIAgent,5000,171,13,ZIAgent,3000,1829
0,38,3876.969466238703,76.96946623870281,4771,3,ZIAgent,7000,2229,12,ZIAgent,2000,2771
0,39,3903.318714507548,3.3187145075480657,5493,4,ZIAgent,6500,1007,13,ZIAgent,3000,2493
0,39,3931.925604861702,31.92560486170214,5948,3,ZIAgent,7000,1052,12,ZIAgent,2000,3948
0,39,3934.8121847467714,34.812184746771436,6166,2,ZIAgent,7500,1334,11,ZIAgent,1000,5166
0,39,3967.3759490552106,67.37594905521064,4534,1,ZIAgent,8000,3466,14,ZIAgent,4000,534
0,40,4020.9154563419497,20.91545634194972,5897,3,ZIAgent,7000,1103,14,ZIAgent,4000,1897
0,40,4043.7021570336933,43.70215703369331,6402,1,ZIAgent,8000,1598,15,ZIAgent,5000,1402
0,40,4048.176983965563,48.17698396556307,5203,2,ZIAgent,7500,2297,11,ZIAgent,1000,4203
0,40,4056.2966029351214,56.29660293512143,4983,5,ZIAgent,6000,1017,12,ZIAgent,2000,2983
0,40,4064.7187860600798,64.71878606007976,4599,4,ZIAgent,6500,1901,13,ZIAgent,3000,1599
0,41,4110.085414287529,10.085414287528693,5736,2,ZIAgent,7500,1764,12,ZIAgent,2000,3736
0,41,4129.552519850752,29.552519850752105,5212,5,ZIAgent,6000,788,13,ZIAgent,3000,2212
0,41,4149.651821626166,49.651821626165656,5852,3,ZIAgent,7000,1148,14,ZIAgent,4000,1852
0,41,4167.439110571011,67.43911057101104,4003,1,ZIAgent,8000,3997,11,ZIAgent,1000,3003
0,42,4206.57599703705,6.575997037050001,5237,5,ZIAgent,6000,763,11,ZIAgent,1000,4237
0,42,4215.362492517098,15.362492517097962,6391,2,ZIAgent,7500,1109,12,ZIAgent,2000,4391
0,42,4235.561652884228,35.56165288422835,6703,1,ZIAgent,8000,1297,14,ZIAgent,4000,2703
0,42,4261.383096276476,61.38309627647595,4037,7,ZIAgent,5000,963,13,ZIAgent,3000,1037
0,43,4309.280243965047,9.280243965046793,5344,1,ZIAgent,8000,2656,14,ZIAgent,4000,1344
0,43,4309.529053297059,9.529053297059363,4973,2,ZIAgent,7500,2527,12,ZIAgent,2000,2973
0,43,4335.727983399872,35.727983399871846,4893,5,ZIAgent,6000,1107,11,ZIAgent,1000,3893
0,44,4409.684615937977,9.68461593797656,4419,5,ZIAgent,6000,1581,12,ZIAgent,2000,2419
0,44,4417.157997960086,17.157997960085595,4923,2,ZIAgent,7500,2577,11,ZIAgent,1000,3923
0,44,4427.176331697574,27.176331697573914,5810,1,ZIAgent,8000,2190,13,ZIAgent,3000,2810
0,44,4472.860075054138,72.86007505413818,5838,4,ZIAgent,6500,662,15,ZIAgent,5000,838
0,45,4509.754215216421,9.754215216420562,5823,5,ZIAgent,6000,177,14,ZIAgent,4000,1823
0,45,4517.126730954387,17.126730954387313,5090,3,ZIAgent,7000,1910,15,ZIAgent,5000,90
0,45,4519.846908458627,19.846908458626785,5525,2,ZIAgent,7500,1975,12,ZIAgent,2000,3525
0,45,4535.558028683031,35.5580286830309,3773,4,ZIAgent,6500,2727,11,ZIAgent,1000,2773
0,45,4539.786037853441,39.786037853440575,5445,1,ZIAgent,8000,2555,13,ZIAgent,3000,2445
0,46,4608.137490026584,8.137490026583691,5257,5,ZIAgent,6000,743,12,ZIAgent,2000,3257
0,46,4619.2524486937655,19.252448693765473,7510,1,ZIAgent,8000,490,16,ZIAgent,6000,1510
0,46,4619.361888552047,19.361888552047276,4006,4,ZIAgent,6500,2494,11,ZIAgent,1000,3006
0,46,4630.8366370714275,30.836637071427504,4248,2,ZIAgent,7500,3252,13,ZIAgent,3000,1248
0,46,4662.4574917142545,62.4574917142545,5061,3,ZIAgent,7000,1939,14,ZIAgent,4000,1061
0,47,4718.165372464756,18.16537246475582,6107,3,ZIAgent,7000,893,14,ZIAgent,4000,2107
0,47,4718.213038601854,18.21303860185435,5648,2,ZIAgent,7500,1852,13,ZIAgent,3000,2648
0,47,4720.971760344898,20.97176034489803,5427,5,ZIAgent,6000,573,12,ZIAgent,2000,3427
0,47,4740.230151677872,40.23015167787162,3876,9,ZIAgent,4000,124,11,ZIAgent,1000,2876
0,47,4767.978155311937,67.97815531193737,7682,1,ZIAgent,8000,318,15,ZIAgent,5000,2682
0,48,4804.26653823855,4.266538238550311,6461,3,ZIAgent,7000,539,15,ZIAgent,5000,1461
0,48,4806.109862132812,6.109862132811941,5548,4,ZIAgent,6500,952,11,ZIAgent,1000,4548
0,48,4817.350446691038,17.350446691038087,6286,1,ZIAgent,8000,1714,14,ZIAgent,4000,2286
0,48,4818.209600278695,18.20960027869478,5360,5,ZIAgent,6000,640,12,ZIAgent,2000,3360
0,48,4825.1137205319255,25.113720531925537,4623,2,ZIAgent,7500,2877,13,ZIAgent,3000,1623
0,49,4912.763208992322,12.763208992321779,3727,8,ZIAgent,4500,773,12,ZIAgent,2000,1727
0,49,4917.492581442682,17.49258144268242,5822,2,ZIAgent,7500,1678,14,ZIAgent,4000,1822
0,49,4922.342379920899,22.342379920898566,4150,3,ZIAgent,7000,2850,11,ZIAgent,1000,3150
0,49,4948.674280748476,48.67428074847612,6104,4,ZIAgent,6500,396,16,ZIAgent,6000,104
0,50,5016.27119210615,16.27119210615001,5838,2,ZIAgent,7500,1662,15,ZIAgent,5000,838
0,50,5018.475236517798,18.475236517798294,4638,3,ZIAgent,7000,2362,11,ZIAgent,1000,3638
0,50,5024.0442240770835,24.044224077083527,5781,1,ZIAgent,8000,2219,12,ZIAgent,2000,3781
0,50,5064.008512359922,64.00851235992195,5340,5,ZIAgent,6000,660,14,ZIAgent,4000,1340
0,51,5108.364628562171,8.364628562170765,4119,3,ZIAgent,7000,2881,14,ZIAgent,4000,119
0,51,5116.391175505673,16.391175505673345,3995,6,ZIAgent,5500,1505,11,ZIAgent,1000,2995
0,51,5126.638117749315,26.638117749314915,4141,7,ZIAgent,5000,859,13,ZIAgent,3000,1141
0,51,5188.147611597344,88.14761159734371,6741,1,ZIAgent,8000,1259,15,ZIAgent,5000,1741
0,52,5221.813976740768,21.81397674076834,6837,1,ZIAgent,8000,1163,14,ZIAgent,4000,2837
0,52,5226.542061023102,26.54206102310218,3955,2,ZIAgent,7500,3545,12,ZIAgent,2000,1955
0,52,5232.477170350132,32.47717035013193,5209,5,ZIAgent,6000,791,11,ZIAgent,1000,4209
0,52,5249.575439275045,49.57543927504503,5103,4,ZIAgent,6500,1397,13,ZIAgent,3000,2103
0,53,5303.524235261309,3.524235261308604,4412,4,ZIAgent,6500,2088,14,ZIAgent,4000,412
0,53,5317.076233552219,17.076233552218582,4699,3,ZIAgent,7000,2301,11,ZIAgent,1000,3699
0,53,5339.787667559187,39.78766755918696,6244,1,ZIAgent,8000,1756,12,ZIAgent,2000,4244
0,53,5347.126289932283,47.126289932282816,5314,2,ZIAgent,7500,2186,15,ZIAgent,5000,314
0,53,5365.250450966391,65.25045096639133,4243,5,ZIAgent,6000,1757,13,ZIAgent,3000,1243
0,54,5407.046852754465,7.0468527544653625,6333,3,ZIAgent,7000,667,12,ZIAgent,2000,4333
0,54,5422.075461355868,22.075461355868356,4712,4,ZIAgent,6500,1788,13,ZIAgent,3000,1712
0,54,5422.555260604677,22.555260604676732,3693,8,ZIAgent,4500,807,11,ZIAgent,1000,2693
0,54,5445.563239702696,45.56323970269568,5400,1,ZIAgent,8000,2600,14,ZIAgent,4000,1400
0,55,5502.368580766362,2.3685807663623564,7744,1,ZIAgent,8000,256,14,ZIAgent,4000,3744
0,55,5503.433880375765,3.433880375764602,5526,4,ZIAgent,6500,974,11,ZIAgent,1000,4526
0,55,5516.120347460564,16.120347460563607,5916,5,ZIAgent,6000,84,12,ZIAgent,2000,3916
0,55,5521.062772687357,21.06277268735721,6323,3,ZIAgent,7000,677,16,ZIAgent,6000,323
0,55,5524.510063597002,24.510063597002045,7270,2,ZIAgent,7500,230,15,ZIAgent,5000,2270
0,55,5579.729851568072,79.72985156807226,3538,8,ZIAgent,4500,962,13,ZIAgent,3000,538
0,56,5602.586680558931,2.5866805589312207,6848,3,ZIAgent,7000,152,12,ZIAgent,2000,4848
0,56,5611.108767262685,11.108767262685433,5570,1,ZIAgent,8000,2430,14,ZIAgent,4000,1570
0,56,5614.704732106741,14.704732106741176,5229,6,ZIAgent,5500,271,15,ZIAgent,5000,229
0,56,5622.454523237175,22.454523237174726,5386,2,ZIAgent,7500,2114,11,ZIAgent,1000,4386
0,56,5643.562832844125,43.562832844125296,3770,4,ZIAgent,6500,2730,13,ZIAgent,3000,770
0,57,5705.705383999231,5.705383999231344,7146,1,ZIAgent,8000,854,17,ZIAgent,7000,146
0,57,5714.638486586534,14.638486586533872,7038,2,ZIAgent,7500,462,14,ZIAgent,4000,3038
0,57,5719.23656773913,19.236567739129896,4581,7,ZIAgent,5000,419,12,ZIAgent,2000,2581
0,57,5721.128824891818,21.128824891818113,4630,5,ZIAgent,6000,1370,13,ZIAgent,3000,1630
0,57,5769.892375376541,69.89237537654117,6794,3,ZIAgent,7000,206,11,ZIAgent,1000,5794
0,58,5808.386152470156,8.386152470156048,6757,1,ZIAgent,8000,1243,14,ZIAgent,4000,2757
0,58,5819.23177736929,19.231777369290285,5711,3,ZIAgent,7000,1289,12,ZIAgent,2000,3711
0,58,5834.626578179198,34.62657817919808,4221,4,ZIAgent,6500,2279,13,ZIAgent,3000,1221
0,59,5905.187537177096,5.187537177095692,4910,3,ZIAgent,7000,2090,11,ZIAgent,1000,3910
0,59,5924.136417635813,24.136417635812904,5332,2,ZIAgent,7500,2168,15,ZIAgent,5000,332
0,59,5969.142749401849,69.14274940184896,5342,1,ZIAgent,8000,2658,13,ZIAgent,3000,2342
0,59,5990.759402048412,90.75940204841208,4585,7,ZIAgent,5000,415,12,ZIAgent,2000,2585
0,60,6002.888278773296,2.888278773296406,4876,4,ZIAgent,6500,1624,12,ZIAgent,2000,2876
0,60,6018.796402935972,18.796402935971855,4790,6,ZIAgent,5500,710,13,ZIAgent,3000,1790
0,60,6026.682192859756,26.68219285975556,6348,3,ZIAgent,7000,652,15,ZIAgent,5000,1348
0,60,6029.292979317481,29.292979317480786,3484,2,ZIAgent,7500,4016,11,ZIAgent,1000,2484
0,60,6089.74824598217,89.74824598217037,7469,1,ZIAgent,8000,531,14,ZIAgent,4000,3469
0,61,6110.77647138145,10.776471381450392,5574,5,ZIAgent,6000,426,11,ZIAgent,1000,4574
0,61,6127.363958906749,27.36395890674885,5697,2,ZIAgent,7500,1803,13,ZIAgent,3000,2697
0,61,6154.158445886808,54.158445886808295,4718,1,ZIAgent,8000,3282,12,ZIAgent,2000,2718
0,62,6200.94547003294,0.9454700329397383,3995,2,ZIAgent,7500,3505,12,ZIAgent,2000,1995
0,62,6205.507124399293,5.507124399293389,4244,7,ZIAgent,5000,756,11,ZIAgent,1000,3244
0,62,6227.663320256068,27.66332025606789,7069,1,ZIAgent,8000,931,14,ZIAgent,4000,3069
0,62,6234.039331946587,34.03933194658657,4387,6,ZIAgent,5500,1113,13,ZIAgent,3000,1387
0,62,6294.313408351213,94.31340835121318,6223,3,ZIAgent,7000,777,15,ZIAgent,5000,1223
0,63,6305.273875565324,5.2738755653235785,6871,2,ZIAgent,7500,629,11,ZIAgent,1000,5871
0,63,6310.841651283811,10.841651283811188,5610,5,ZIAgent,6000,390,12,ZIAgent,2000,3610
0,63,6318.230807448787,18.230807448787345,6243,1,ZIAgent,8000,1757,16,ZIAgent,6000,243
0,63,6363.846134317252,63.84613431725211,5231,3,ZIAgent,7000,1769,13,ZIAgent,3000,2231
0,64,6400.434146684494,0.43414668449440796,4335,8,ZIAgent,4500,165,12,ZIAgent,2000,2335
0,64,6412.213787321028,12.213787321027667,5181,1,ZIAgent,8000,2819,11,ZIAgent,1000,4181
0,64,6414.784768626138,14.78476862613843,6819,2,ZIAgent,7500,681,16,ZIAgent,6000,819
0,64,6427.893443722159,27.893443722158736,5151,3,ZIAgent,7000,1849,13,ZIAgent,3000,2151
0,64,6445.6571915679415,45.65719156794148,5361,5,ZIAgent,6000,639,14,ZIAgent,4000,1361
0,65,6503.735626474186,3.735626474185665,6393,1,ZIAgent,8000,1607,11,ZIAgent,1000,5393
0,65,6506.235057496269,6.235057496269292,5729,3,ZIAgent,7000,1271,14,ZIAgent,4000,1729
0,65,6576.37028279683,76.37028279683,4376,2,ZIAgent,7500,3124,12,ZIAgent,2000,2376
0,66,6604.047789973234,4.047789973234103,6923,1,ZIAgent,8000,1077,14,ZIAgent,4000,2923
0,66,6622.638237124499,22.638237124499028,4629,3,ZIAgent,7000,2371,12,ZIAgent,2000,2629
0,66,6677.707414013476,77.70741401347641,5142,5,ZIAgent,6000,858,11,ZIAgent,1000,4142
0,67,6707.695731396358,7.695731396357587,4471,5,ZIAgent,6000,1529,13,ZIAgent,3000,1471
0,67,6716.223011032298,16.223011032298018,3889,3,ZIAgent,7000,3111,11,ZIAgent,1000,2889
0,67,6735.985519282888,35.98551928288816,5904,2,ZIAgent,7500,1596,12,ZIAgent,2000,3904
0,67,6753.568496590811,53.568496590811264,5112,1,ZIAgent,8000,2888,15,ZIAgent,5000,112
0,68,6804.202938965227,4.2029389652270766,4778,3,ZIAgent,7000,2222,11,ZIAgent,1000,3778
0,68,6813.481509860297,13.481509860296683,6307,1,ZIAgent,8000,1693,15,ZIAgent,5000,1307
0,68,6817.491642484621,17.49164248462057,4871,4,ZIAgent,6500,1629,13,ZIAgent,3000,1871
0,68,6819.109468494788,19.109468494788416,3661,2,ZIAgent,7500,3839,12,ZIAgent,2000,1661
0,69,6906.363469141766,6.363469141765563,5126,4,ZIAgent,6500,1374,12,ZIAgent,2000,3126
0,69,6908.575811123169,8.575811123168933,5029,2,ZIAgent,7500,2471,11,ZIAgent,1000,4029
0,69,6931.693969079594,31.693969079594353,4558,5,ZIAgent,6000,1442,13,ZIAgent,3000,1558
0,69,6956.511294220849,56.51129422084887,7050,1,ZIAgent,8000,950,16,ZIAgent,6000,1050
0,70,7005.778040597468,5.778040597468134,5110,3,ZIAgent,7000,1890,14,ZIAgent,4000,1110
0,70,7019.736032898564,19.73603289856419,3758,5,ZIAgent,6000,2242,13,ZIAgent,3000,758
0,70,7022.321930476995,22.321930476994567,6589,1,ZIAgent,8000,1411,16,ZIAgent,6000,589
0,70,7027.761138479627,27.761138479627334,3740,2,ZIAgent,7500,3760,12,ZIAgent,2000,1740
0,70,7069.427507588699,69.42750758869897,6140,4,ZIAgent,6500,360,11,ZIAgent,1000,5140
0,71,7106.401959478954,6.401959478954268,5872,4,ZIAgent,6500,628,11,ZIAgent,1000,4872
0,71,7142.734471628896,42.734471628896245,6240,2,ZIAgent,7500,1260,12,ZIAgent,2000,4240
0,71,7147.529795021514,47.529795021513564,4851,3,ZIAgent,7000,2149,13,ZIAgent,3000,1851
0,72,7215.467142505865,15.467142505865013,5916,3,ZIAgent,7000,1084,15,ZIAgent,5000,916
0,72,7217.162584567278,17.162584567277918,6267,1,ZIAgent,8000,1733,13,ZIAgent,3000,3267
0,72,7229.6974289069085,29.6974289069085,5119,5,ZIAgent,6000,881,12,ZIAgent,2000,3119
0,72,7233.50294100024,33.502941000239844,4604,4,ZIAgent,6500,1896,11,ZIAgent,1000,3604
0,72,7235.222004360457,35.222004360456594,4418,8,ZIAgent,4500,82,14,ZIAgent,4000,418
0,73,7304.803831555646,4.8038315556459565,3323,5,ZIAgent,6000,2677,11,ZIAgent,1000,2323
0,73,7311.984883038665,11.98488303866543,4403,3,ZIAgent,7000,2597,12,ZIAgent,2000,2403
0,73,7317.459397990472,17.459397990472098,6253,1,ZIAgent,8000,1747,16,ZIAgent,6000,253
0,73,7329.963393108965,29.963393108964738,5867,2,ZIAgent,7500,1633,13,ZIAgent,3000,2867
0,73,7355.249699656031,55.249699656031225,5543,4,ZIAgent,6500,957,15,ZIAgent,5000,543
0,74,7408.822416389541,8.822416389541104,5014,2,ZIAgent,7500,2486,12,ZIAgent,2000,3014
0,74,7410.121925018894,10.121925018894217,5016,1,ZIAgent,8000,2984,14,ZIAgent,4000,1016
0,74,7435.038433303078,35.03843330307791,5175,4,ZIAgent,6500,1325,11,ZIAgent,1000,4175
0,74,7489.056683653023,89.05668365302336,6620,3,ZIAgent,7000,380,16,ZIAgent,6000,620
0,75,7504.462749108184,4.462749108183743,4556,3,ZIAgent,7000,2444,11,ZIAgent,1000,3556
0,75,7512.159983085947,12.159983085946806,4073,1,ZIAgent,8000,3927,12,ZIAgent,2000,2073
0,75,7531.293058551728,31.29305855172788,4742,4,ZIAgent,6500,1758,13,ZIAgent,3000,1742
0,75,7542.195452232761,42.195452232761454,5249,5,ZIAgent,6000,751,14,ZIAgent,4000,1249
0,75,7556.081265519974,56.081265519974295,5817,2,ZIAgent,7500,1683,15,ZIAgent,5000,817
0,76,7608.081833818328,8.08183381832805,5783,1,ZIAgent,8000,2217,11,ZIAgent,1000,4783
0,76,7611.587998883525,11.58799888352496,6217,2,ZIAgent,7500,1283,15,ZIAgent,5000,1217
0,76,7622.272411834424,22.27241183442402,3779,9,ZIAgent,4000,221,13,ZIAgent,3000,779
0,76,7654.136778272691,54.13677827269112,6185,3,ZIAgent,7000,815,12,ZIAgent,2000,4185
0,77,7707.769042742074,7.769042742073907,4976,5,ZIAgent,6000,1024,13,ZIAgent,3000,1976
0,77,7710.771274877451,10.771274877451106,4830,3,ZIAgent,7000,2170,11,ZIAgent,1000,3830
0,77,7716.894851220033,16.89485122003316,6484,2,ZIAgent,7500,1016,12,ZIAgent,2000,4484
0,77,7773.6028299391955,73.60282993919554,5045,6,ZIAgent,5500,455,14,ZIAgent,4000,1045
0,78,7801.543188182289,1.543188182288759,3439,4,ZIAgent,6500,3061,11,ZIAgent,1000,2439
0,78,7803.084261630942,3.08426163094191,4209,8,ZIAgent,4500,291,12,ZIAgent,2000,2209
0,78,7830.614849309983,30.614849309982674,6263,2,ZIAgent,7500,1237,16,ZIAgent,6000,263
0,78,7856.702242513426,56.70224251342643,5967,5,ZIAgent,6000,33,14,ZIAgent,4000,1967
0,79,7902.113289893131,2.1132898931309683,2096,2,ZIAgent,7500,5404,11,ZIAgent,1000,1096
0,79,7903.970453145025,3.9704531450252034,4522,1,ZIAgent,8000,3478,12,ZIAgent,2000,2522
0,79,7928.973762463496,28.973762463496314,6752,3,ZIAgent,7000,248,16,ZIAgent,6000,752
0,79,7946.956761896701,46.95676189670121,5397,6,ZIAgent,5500,103,13,ZIAgent,3000,2397
0,79,7974.546842720036,74.54684272003578,4888,4,ZIAgent,6500,1612,14,ZIAgent,4000,888
0,80,8008.297714236848,8.297714236848151,5060,4,ZIAgent,6500,1440,14,ZIAgent,4000,1060
0,80,8019.565165048331,19.565165048331437,6083,1,ZIAgent,8000,1917,11,ZIAgent,1000,5083
0,80,8021.610182591068,21.610182591068224,3768,2,ZIAgent,7500,3732,13,ZIAgent,3000,768
0,80,8043.456378983198,43.45637898319819,4272,7,ZIAgent,5000,728,12,ZIAgent,2000,2272
0,80,8097.550527982792,97.55052798279212,6318,3,ZIAgent,7000,682,15,ZIAgent,5000,1318
0,81,8101.904672245338,1.9046722453376788,3725,1,ZIAgent,8000,4275,13,ZIAgent,3000,725
0,81,8136.671030691033,36.67103069103268,4381,3,ZIAgent,7000,2619,11,ZIAgent,1000,3381
0,81,8148.8035498278405,48.80354982784047,5597,4,ZIAgent,6500,903,14,ZIAgent,4000,1597
0,81,8176.205215112798,76.20521511279821,6508,2,ZIAgent,7500,992,12,ZIAgent,2000,4508
0,82,8212.110125175837,12.110125175837311,4521,5,ZIAgent,6000,1479,11,ZIAgent,1000,3521
0,82,8214.687055496384,14.687055496384346,4206,8,ZIAgent,4500,294,13,ZIAgent,3000,1206
0,82,8217.591426103108,17.59142610310846,4572,6,ZIAgent,5500,928,12,ZIAgent,2000,2572
0,82,8227.02519699278,27.025196992779456,5764,1,ZIAgent,8000,2236,14,ZIAgent,4000,1764
0,82,8259.116687857722,59.116687857722354,5703,4,ZIAgent,6500,797,15,ZIAgent,5000,703
0,83,8308.153887249742,8.153887249742183,5449,3,ZIAgent,7000,1551,11,ZIAgent,1000,4449
0,83,8316.02789768468,16.027897684680283,5746,1,ZIAgent,8000,2254,13,ZIAgent,3000,2746
0,83,8319.367731387658,19.36773138765784,4918,7,ZIAgent,5000,82,14,ZIAgent,4000,918
0,83,8325.775512279843,25.775512279842587,5238,5,ZIAgent,6000,762,12,ZIAgent,2000,3238
0,83,8368.49935876102,68.49935876102063,5229,4,ZIAgent,6500,1271,15,ZIAgent,5000,229
0,84,8407.900169022358,7.900169022357659,5541,4,ZIAgent,6500,959,13,ZIAgent,3000,2541
0,84,8408.834674619651,8.834674619651196,4991,5,ZIAgent,6000,1009,12,ZIAgent,2000,2991
0,84,8428.775843200963,28.77584320096321,5599,2,ZIAgent,7500,1901,14,ZIAgent,4000,1599
0,84,8446.744758365672,46.74475836567217,3569,7,ZIAgent,5000,1431,11,ZIAgent,1000,2569
0,84,8486.041525042669,86.04152504266858,6624,1,ZIAgent,8000,1376,15,ZIAgent,5000,1624
0,85,8512.234755740099,12.23475574009899,4831,1,ZIAgent,8000,3169,14,ZIAgent,4000,831
0,85,8526.006957811232,26.006957811232496,5803,3,ZIAgent,7000,1197,12,ZIAgent,2000,3803
0,85,8529.46633976093,29.46633976092926,5429,5,ZIAgent,6000,571,13,ZIAgent,3000,2429
0,85,8535.33221272861,35.3322127286101,5634,4,ZIAgent,6500,866,15,ZIAgent,5000,634
0,85,8540.92287875836,40.92287875835973,5425,6,ZIAgent,5500,75,11,ZIAgent,1000,4425
0,86,8616.838434730582,16.838434730581866,5717,2,ZIAgent,7500,1783,14,ZIAgent,4000,1717
0,86,8634.40535871818,34.40535871818065,4969,3,ZIAgent,7000,2031,12,ZIAgent,2000,2969
0,86,8635.358798340807,35.35879834080697,2948,4,ZIAgent,6500,3552,11,ZIAgent,1000,1948
0,86,8665.145613458355,65.145613458355,4384,8,ZIAgent,4500,116,13,ZIAgent,3000,1384
0,86,8670.452237187796,70.45223718779562,6858,1,ZIAgent,8000,1142,15,ZIAgent,5000,1858
0,87,8703.249949644947,3.2499496449472645,6235,4,ZIAgent,6500,265,12,ZIAgent,2000,4235
0,87,8713.234025131038,13.234025131037924,4108,8,ZIAgent,4500,392,11,ZIAgent,1000,3108
0,87,8729.292264337535,29.292264337535016,5144,1,ZIAgent,8000,2856,13,ZIAgent,3000,2144
0,87,8761.449203020178,61.449203020178174,4666,7,ZIAgent,5000,334,14,ZIAgent,4000,666
0,87,8761.574509715474,61.57450971547405,5877,2,ZIAgent,7500,1623,15,ZIAgent,5000,877
0,88,8813.604501071639,13.604501071638879,5335,6,ZIAgent,5500,165,12,ZIAgent,2000,3335
0,88,8818.785013458879,18.785013458878893,6531,3,ZIAgent,7000,469,11,ZIAgent,1000,5531
0,88,8821.466312349305,21.466312349304644,5810,4,ZIAgent,6500,690,13,ZIAgent,3000,2810
0,88,8834.215061002475,34.21506100247461,7798,1,ZIAgent,8000,202,14,ZIAgent,4000,3798
0,89,8908.838402184043,8.838402184042934,4255,8,ZIAgent,4500,245,11,ZIAgent,1000,3255
0,89,8912.692137818512,12.692137818512492,5106,4,ZIAgent,6500,1394,12,ZIAgent,2000,3106
0,89,8936.618873430192,36.61887343019225,5758,1,ZIAgent,8000,2242,15,ZIAgent,5000,758
0,89,8952.358284242806,52.358284242805894,5870,2,ZIAgent,7500,1630,14,ZIAgent,4000,1870
0,89,8994.316548981755,94.31654898175475,5290,5,ZIAgent,6000,710,13,ZIAgent,3000,2290
0,90,9018.720802167532,18.720802167532383,5721,3,ZIAgent,7000,1279,13,ZIAgent,3000,2721
0,90,9024.72801162508,24.7280116250804,5666,5,ZIAgent,6000,334,12,ZIAgent,2000,3666
0,90,9032.4191788229,32.419178822899994,5543,1,ZIAgent,8000,2457,11,ZIAgent,1000,4543
0,90,9069.700698787734,69.70069878773393,6823,2,ZIAgent,7500,677,15,ZIAgent,5000,1823
0,90,9087.388711320527,87.38871132052736,4320,8,ZIAgent,4500,180,14,ZIAgent,4000,320
0,91,9118.718145152876,18.718145152875877,5436,3,ZIAgent,7000,1564,12,ZIAgent,2000,3436
0,91,9120.789065833214,20.78906583321441,7127,1,ZIAgent,8000,873,14,ZIAgent,4000,3127
0,91,9154.967375505159,54.967375505159,4274,2,ZIAgent,7500,3226,11,ZIAgent,1000,3274
0,91,9163.604587510798,63.6045875107975,6332,4,ZIAgent,6500,168,16,ZIAgent,6000,332
0,91,9195.287826339127,95.2878263391267,4373,6,ZIAgent,5500,1127,13,ZIAgent,3000,1373
0,92,9208.188592492133,8.188592492133466,4398,7,ZIAgent,5000,602,12,ZIAgent,2000,2398
0,92,9221.067769881332,21.067769881332424,5005,2,ZIAgent,7500,2495,11,ZIAgent,1000,4005
0,92,9223.568548782312,23.568548782312064,5220,6,ZIAgent,5500,280,13,ZIAgent,3000,2220
0,92,9229.958689048353,29.958689048353335,7016,1,ZIAgent,8000,984,15,ZIAgent,5000,2016
0,92,9280.757523858138,80.75752385813757,6880,3,ZIAgent,7000,120,14,ZIAgent,4000,2880
0,93,9306.428572886385,6.428572886385155,5300,3,ZIAgent,7000,1700,12,ZIAgent,2000,3300
0,93,9310.803584735113,10.803584735112963,5322,1,ZIAgent,8000,2678,14,ZIAgent,4000,1322
0,93,9327.500673582836,27.50067358283559,5982,2,ZIAgent,7500,1518,13,ZIAgent,3000,2982
0,93,9360.069374819786,60.06937481978639,4438,5,ZIAgent,6000,1562,11,ZIAgent,1000,3438
0,94,9401.758877401726,1.7588774017258402,4606,5,ZIAgent,6000,1394,11,ZIAgent,1000,3606
0,94,9402.942306076064,2.942306076063687,4543,6,ZIAgent,5500,957,14,ZIAgent,4000,543
0,94,9415.857675412442,15.857675412442404,6663,2,ZIAgent,7500,837,15,ZIAgent,5000,1663
0,94,9437.17703861479,37.177038614789126,6018,3,ZIAgent,7000,982,16,ZIAgent,6000,18
0,94,9442.228674984677,42.22867498467713,3737,8,ZIAgent,4500,763,12,ZIAgent,2000,1737
0,94,9450.65587253951,50.6558725395098,3515,9,ZIAgent,4000,485,13,ZIAgent,3000,515
0,95,9508.51593998209,8.515939982089549,5985,1,ZIAgent,8000,2015,14,ZIAgent,4000,1985
0,95,9513.04251939377,13.042519393769908,5004,2,ZIAgent,7500,2496,11,ZIAgent,1000,4004
0,95,9518.595397547799,18.59539754779871,5553,5,ZIAgent,6000,447,13,ZIAgent,3000,2553
0,95,9559.534553844156,59.53455384415611,3870,8,ZIAgent,4500,630,12,ZIAgent,2000,1870
0,95,9568.413594217871,68.41359421787092,6471,4,ZIAgent,6500,29,15,ZIAgent,5000,1471
0,96,9602.572846600497,2.572846600496632,5448,2,ZIAgent,7500,2052,11,ZIAgent,1000,4448
0,96,9605.33343604979,5.33343604979018,6957,3,ZIAgent,7000,43,16,ZIAgent,6000,957
0,96,9638.408254224873,38.40825422487251,4927,5,ZIAgent,6000,1073,13,ZIAgent,3000,1927
0,96,9652.054874342746,52.05487434274619,4673,7,ZIAgent,5000,327,12,ZIAgent,2000,2673
0,96,9680.991877540042,80.99187754004197,5411,4,ZIAgent,6500,1089,14,ZIAgent,4000,1411
0,97,9719.688583210482,19.688583210481738,4132,6,ZIAgent,5500,1368,11,ZIAgent,1000,3132
0,97,9733.630608446765,33.63060844676511,6410,3,ZIAgent,7000,590,12,ZIAgent,2000,4410
0,97,9764.112662642552,64.1126626425521,5732,1,ZIAgent,8000,2268,13,ZIAgent,3000,2732
0,97,9787.53031268353,87.5303126835297,5962,4,ZIAgent,6500,538,14,ZIAgent,4000,1962
0,98,9801.115084707064,1.115084707063943,1754,1,ZIAgent,8000,6246,11,ZIAgent,1000,754
0,98,9804.67121684667,4.671216846669267,4526,3,ZIAgent,7000,2474,14,ZIAgent,4000,526
0,98,9817.844410848822,17.844410848822008,6316,4,ZIAgent,6500,184,13,ZIAgent,3000,3316
0,98,9824.630979406178,24.630979406178085,7272,2,ZIAgent,7500,228,15,ZIAgent,5000,2272
0,98,9832.105795754635,32.10579575463453,3833,7,ZIAgent,5000,1167,12,ZIAgent,2000,1833
0,99,9904.307725619208,4.307725619208213,4310,3,ZIAgent,7000,2690,13,ZIAgent,3000,1310
0,99,9940.33952417871,40.339524178709325,6430,1,ZIAgent,8000,1570,11,ZIAgent,1000,5430
0,99,9951.209232970907,51.20923297090667,4967,7,ZIAgent,5000,33,14,ZIAgent,4000,967
0,99,9955.045425249593,55.04542524959288,4359,8,ZIAgent,4500,141,12,ZIAgent,2000,2359
0,100,10005.214075812248,5.214075812247756,4425,8,ZIAgent,4500,75,12,ZIAgent,2000,2425
0,100,10008.125149405667,8.125149405666889,5629,4,ZIAgent,6500,871,11,ZIAgent,1000,4629
0,100,10027.363264420248,27.363264420248015,6493,2,ZIAgent,7500,1007,13,ZIAgent,3000,3493
0,100,10057.959576522362,57.95957652236211,5607,1,ZIAgent,8000,2393,14,ZIAgent,4000,1607
